#CODE	ENGLISH	ENGLISH
EVTDESC60010	The great [Root.GetTitledName] and all [Root.GetHerHis] vassals have converted and embraced the Catholic faith!	The great [Root.GetTitledName] and all [Root.GetHerHis] vassals have converted and embraced the Catholic faith!
EVTDESC60011	The great [Root.GetTitledName] and all [Root.GetHerHis] vassals have converted and embraced the Orthodox faith!	The great [Root.GetTitledName] and all [Root.GetHerHis] vassals have converted and embraced the Orthodox faith!
EVTDESC60012	The great [Root.GetTitledName] and all [Root.GetHerHis] vassals have converted and embraced the Sunni faith!	The great [Root.GetTitledName] and all [Root.GetHerHis] vassals have converted and embraced the Sunni faith!
EVTDESC60013	The great [Root.GetTitledName] and all [Root.GetHerHis] vassals have converted and embraced the Shiite faith!	The great [Root.GetTitledName] and all [Root.GetHerHis] vassals have converted and embraced the Shiite faith!
MONTHLY_PROJECTED_COST	Projected Monthly Cost: §Y$COST$§!	Projected Montly Cost: §Y$COST$§!
YEARLY_PROJECTED_COST	Projected Yearly Cost: §Y$COST$§!	Projected Yearly Cost: §Y$COST$§!
PER_MONTH	§Y$VAL$§! / Month	§Y$VAL$§! / Month
AIREASON_KINGDOMS_DONT_ACCEPT_VASSALAGE	I am a King!	I am a King!
ACCEPT	Accept	Accept
DECLINE	Decline	Decline
HAS_LESS_RAISED_TROOP_DAYS	Troops Raised less than §Y$DAYS$§! days\n	Troops Raised less than §Y$DAYS$§! days\n
HAS_MORE_RAISED_TROOP_DAYS	Troops Raised for at least §Y$DAYS$§! days\n	Troops Raised for at least §Y$DAYS$§! days\n
SET_RAISED_TROOP_OPINION	§Y$ACTIVE$'s§! raised levy opinion days vs §Y$PASSIVE$§! set to §Y$MUCH$§!.\n	§Y$ACTIVE$'s§! raised levy opinion days vs §Y$PASSIVE$§! set to §Y$MUCH$§!.\n
CONTESTED_TITLE	Contested title: $TITLE$	Contested title: $TITLE$
THREAT_REASON_HATRED	Low Opinion	Low Opinion
THREAT_REASON_LOVE	High Opinion	High Opinion
THREAT_REASON_CB	Casus Belli	Casus Belli
THREAT_REASON_PRETENDER	Pretender	Pretender
THREAT_REASON_CLAIMANT	Claimant	Claimant
THREAT_REASON_DISTANCE	Distance	Distance
THREAT_LIEGE_CULTURE	Same Culture	Same Culture
THREAT_LIEGE_RELIGION	Same Religion	Same Religion
THREAT_LIEGE_DEJURELIEGE	DeJure Liege	DeJure Liege
INGAME_STORE	Ingame Store	Ingame Store
tut_3c_6	Multilayered Laws	Multilayered Laws
tut_3c_7	When you open the laws screen, you will see the ducal laws of Brittany. Brittany is de jure a part of France though, so the crown laws of france will affect you too. To see how, you need to click the shield to the upper right.	When you open the laws screen, you will see the ducal laws of Brittany. Brittany is de jure a part of France though, so the crown laws of france will affect you too. To see how, you need to click the shield to the upper right.
tut_3c_8	Multilayered Laws II	Multilayered Laws II
tut_3c_9	There are the laws in France that might affect Brittany. On the top part you can see the succesion laws France is using, and also the crowns laws on the bottom half. Click next to end this part.	There are the laws in France that might affect Brittany. On the top part you can see the succesion laws France is using, and also the crowns laws on the bottom half. Click next to end this part.
REINFORCE_TOOLTIP	Next month, $NUM$ new soldier(s) will have been recruited	Next month, $NUM$ new soldier(s) will have been recruited
#other_claim_desc	This Casus Belli can be used by §Y$PRESSER$§! to press §Y$CLAIMANT$'s§! claim on the §Y$TITLE$§!.\nIf §Y$PRESSER$§! and §Y$CLAIMANT$§! are of the same dynasty, or if §Y$PRESSER$§! is de jure liege of §Y$TITLE$§!, §Y$CLAIMANT$§! will also become a vassal of §Y$PRESSER$§!.	This Casus Belli can be used by §Y$PRESSER$§! to press §Y$CLAIMANT$'s§! claim on the §Y$TITLE$§!.\nIf §Y$PRESSER$§! and §Y$CLAIMANT$§! are of the same dynasty, or if §Y$PRESSER$§! is de jure liege of §Y$TITLE$§!, §Y$CLAIMANT$§! will also become a vassal of §Y$PRESSER$§!.
TECH_GROWTH_PROG_SETUP	Advancement Progress in Demesne	Advancement Progress in Demesne
TECH_GROWTH_PROG_LOG	Progress of $TECH$ advancement in $PROV$ increased to §Y$PROG$§!	Progress of $TECH$ advancement in $PROV$ increased to §Y$PROG$§!
TECH_GROWTH_REALM_SETUP	Advancement in Realm	Advancement in Realm
TECH_GROWTH_REALM_LOG	Local knowledge of $TECH$ in $PROV$ increased to level §Y$LEVEL$§!	Local knowledge of $TECH$ in $PROV$ increased to level §Y$LEVEL$§!
TECH_GROWTH_PROG_REALM_SETUP	Advancement Progress in Realm	Advancement Progress in Realm
TECH_GROWTH_PROG_REALM_LOG	Local progress of $TECH$ advancement in $PROV$ increased to §Y$PROG$§!	Local progress of $TECH$ advancement in $PROV$ increased to §Y$PROG$§!
LOADING_TIP_0	A 'demesne' is the collection of Castles, Cities and Temples held by one person.	A 'demesne' is the collection of Castles, Cities and Temples held by one person.
LOADING_TIP_49	Carefully check the traits of your wife	Carefully check the traits of your wife
EVTDESC3340	I almost swallowed my tongue when a friendly courtier paid his respects to me. He thought I was displeased with him and he left perplexed.	I almost swallowed my tongue when a friendly courtier paid his respects to me. He thought I was displeased with him and he left perplexed.
EVTOPTA3340	I think I lost his respect...	I think I lost his respect...
alert_dejure_claim_instant	§YYou can Press de jure Ducal Claims§!	§YYou can Press de jure Ducal Claims§!
alert_dejure_claim_delayed	The following de jure ducal claims can be pressed: $LIST$	The following de jure ducal claims can be pressed: $LIST$
PRESSABLE_CLAIM	$COUNTY$, for $CLAIMANT$	$COUNTY$, for $CLAIMANT$
OPT_draw_trees	Render trees	Render trees
OPT_draw_rivers	Render rivers	Render rivers
OPT_draw_citysprawl	Render city sprawl	Render city sprawl
tut_4c_11	Marriage Effects	Marriage Effects
OPT_legacy_shaders	Legacy graphics mode	Legacy graphics mode
