#CODE	ENGLISH	ENGLISH
PLOT_POWER_CONTRIB_LOWER_THAN	Contribution to $PLOTTER$'s plot to $PLOT$ less than §Y$POWER$%§!\n	Contribution to $PLOTTER$'s plot to $PLOT$ less than §Y$POWER$%§!\n
PLOT_POWER_CONTRIB_AT_LEAST	Contribution to $PLOTTER$'s plot to $PLOT$ at least §Y$POWER$%§!\n	Contribution to $PLOTTER$'s plot to $PLOT$ at least §Y$POWER$%§!\n
#INTERACTION_CANNOT_JOIN_VASSAL_WAR	We cannot join our vassals' wars (except for Crusades/Jihads)	We cannot join our vassals' wars (except for Crusades/Jihads)
KILLER	Killer	Killer
ANY_SPOUSE_STARTS	Any Spouse	Any Spouse
IS_MAIN_SPOUSE	Is the First Spouse	Is the First Spouse
IS_NOT_MAIN_SPOUSE	Is NOT the First Spouse	Is NOT the First Spouse
CONQUEST_CULTURE_EFFECT	Subjugated by §Y$CULTURE$§! Culture\n	Subjugated by §Y$CULTURE$§! Culture\n
CONQUEST_CULTURE_EFFECT_FREED	Freed from the §Y$CULTURE$§! yoke\n	Freed from the §Y$CULTURE$§! yoke\n
MAKE_PRIMARY_SPOUSE_EFFECT	$WHO$ is made the First Spouse of $SPOUSE$.\n	$WHO$ is made the First Spouse of $SPOUSE$.\n
MAKE_NOT_PRIMARY_SPOUSE_EFFECT	$WHO$ is no longer the First Spouse of $SPOUSE$.\n	$WHO$ is no longer the First Spouse of $SPOUSE$.\n
HAVE_CONQUEST_CULTURE	Is subjugated by §Y$CULTURE$§! Culture\n	Is subjugated by §Y$CULTURE$§! Culture\n
HAVNT_CONQUEST_CULTURE	Is NOT subjugated by §Y$CULTURE$§! Culture\n	Is NOT subjugated by §Y$CULTURE$§! Culture\n
DISMISS_ALLOW_DESCRIPTION	Can be dismissed if the following is true:\n	Can be dismissed if the following is true:\n
DIPLO_OF_POPE	Religious Head Diplomacy	Religious Head Diplomacy
INTERACTION_REQUIRES_FEWER_WIVES	§Y$CHAR$§W has fewer than §Y$NUM$§W wives	§Y$CHAR$§W has fewer than §Y$NUM$§W wives
INTERACTION_REQUIRES_NO_OTHER_MARRIAGE	§Y$CHAR$§W is unmarried	§Y$CHAR$§W is unmarried
INTERACTION_REQUIRES_NO_TRUCE_OR_REV_REASON	Must have a special revoke reason if we have a Truce	Must have a special revoke reason if we have a Truce
INTERACTION_VALID_REASON	Since you have a valid reason, no one will care.	Since you have a valid reason, no one will care.
tribal_invasion_desc	We do not need to bother with just causes - might makes right! §Y$CLAIMANT$§! can invade the lands of §Y$TARGET$§!. If successful, the titles to all currently occupied holdings will be seized and all vassals will become our vassals.	We do not need to bother with just causes - might makes right! §Y$CLAIMANT$§! can invade the lands of §Y$TARGET$§!. If successful, the titles to all currently occupied holdings will be seized and all vassals will become our vassals.
decadence_invasion_desc	We do not need to bother with just causes - might makes right! §Y$CLAIMANT$§! can invade the lands of §Y$TARGET$§!.	We do not need to bother with just causes - might makes right! §Y$CLAIMANT$§! can invade the lands of §Y$TARGET$§!.
title_food_taster	Food Taster	Food Taster
title_food_taster_desc	Food tasters have the dubious pleasure of trying all dishes before their master has a bite...	Food tasters have the dubious pleasure of trying all dishes before their master has a bite...
title_court_calligrapher	Court Calligrapher	Court Calligrapher
title_court_calligrapher_desc	Islamic suspicion of figurative art makes skilled calligraphers highly respected.	Islamic suspicion of figurative art makes skilled calligraphers highly respected.
title_court_musician	Court Musician	Court Musician
title_court_musician_desc	The Court Musician is always ready to entertain with soothing or stirring music.	The Court Musician is always ready to entertain with soothing or stirring music.
title_court_poet	Court Poet	Court Poet
title_court_poet_desc	Islamic poets enjoy a great deal of respect and prestige, often religious, but sometimes pushing the limits of what is acceptable under Islam.	Islamic poets enjoy a great deal of respect and prestige, often religious, but sometimes pushing the limits of what is acceptable under Islam.
title_chief_architect	Chief Architect	Chief Architect
title_chief_architect_desc	The Chief Architect is responsible for designing and overseeing the construction of palaces, mosques and grand monuments.	The Chief Architect is responsible for designing and overseeing the construction of palaces, mosques and grand monuments.
title_chief_qadi	Chief Qadi	Chief Qadi
title_chief_qadi_desc	The Chief Qadi is the supreme judge and authority of the Law (Sharia) in the realm. The most prestigious of all Muslim honorary titles, it is only open to characters with a proper religious education.	The Chief Qadi is the supreme judge and authority of the Law (Sharia) in the realm. The most prestigious of all Muslim honorary titles, it is only open to characters with a proper religious education.
title_court_dwarf	Court Dwarf	Court Dwarf
title_court_dwarf_desc	Dwarves are objects of fascination and curiosity. Having one at court is a matter of prestige.	Dwarves are objects of fascination and curiosity. Having one at court is a matter of prestige.
job_spiritual_muslim	Court Imam	Court Imam
job_spiritual_shiite	Court Mullah	Court Mullah
job_chancellor_iranian	Grand Vizier	Grand Vizier
job_chancellor_turkish	Grand Vizier	Grand Vizier
PROV911	Timbuktu	Timbuktu
PROV912	Aoudaghost	Aoudaghost
PROV913	Ghana	Ghana
PROV914	Gao	Gao
PROV915	Djenné	Djenné
PROV916	Taghaza	Taghaza
PROV917	Araouane	Araouane
PROV918	Sijilmasa	Sijilmasa
PROV919	Oualata	Oualata
PROV920	Ouadane	Ouadane
PROV921	Idjil	Idjil
PROV922	Tadmekka	Tadmekka
PROV923	Adrar Plateau	Adrar Plateau
PROV924	Western Sahara	Western Sahara
PROV925	Mali	Mali
PROV926	Bambuk	Bambuk
PROV927	Zarma	Zarma
PROV928	Gurma	Gurma
#TITLE_CREATION_EMPEROR_DESC	You need to control §Y$REQ_PERC$%§! of its de jure Counties to create this title. Currently, you control $PERC$ ($HELD$/§Y$ALL$§!). Creating this title would give you §G$PRESTIGE$§! Prestige and cost you §R$GOLD$§! Gold and §R$PIETY$§! $PIETYNAME$.	You need to control §Y$REQ_PERC$%§! of its de jure Counties to create this title. Currently, you control $PERC$ ($HELD$/§Y$ALL$§!). Creating this title would give you §G$PRESTIGE$§! Prestige and cost you §R$GOLD$§! Gold and §R$PIETY$§! $PIETYNAME$.
c_ifni_adj	Taroudanti	Taroudanti
c_tharasset_adj	Tamdoulti	Tamdoulti
e_persia	Persian Empire	Persian Empire
e_persia_adj	Persian	Persian
e_arabia	Arabian Empire	Arabian Empire
e_arabia_adj	Arabian	Arabian
k_volga_bulgaria	Volga Bulgaria	Volga Bulgaria
k_volga_bulgaria_adj	Volga Bulgarian	Volga Bulgarian
k_perm	Perm	Perm
k_perm_adj	Permian	Permian
k_taurica	Taurica	Taurica
k_taurica_adj	Taurican	Taurican
k_alania	Alania	Alania
k_alania_adj	Alanian	Alanian
k_khiva	Khiva	Khiva
k_khiva_adj	Khivan	Khivan
e_britannia	Britannia	Britannia
e_britannia_adj	British	British
e_spain	Hispania	Hispania
e_spain_adj	Hispanian	Hispanian
west_african	West African	West African
manden	Mandé	Mandé
k_byzantium	Greece	Greece
k_byzantium_adj	Greek	Greek
k_anatolia	Anatolia	Anatolia
k_anatolia_adj	Anatolian	Anatolian
k_ruthenia	Ruthenia	Ruthenia
k_ruthenia_adj	Ruthenian	Ruthenian
e_russia	Russia	Russia
e_russia_adj	Russian	Russian
e_scandinavia	Scandinavia	Scandinavia
e_scandinavia_adj	Scandinavian	Scandinavian
e_france	Francia	Francia
e_france_adj	French	French
mujahid	Mujahid	Mujahid
mujahid_desc	This character is a veteran of a Jihad.	This character is a veteran of a Jihad.
hajjaj	Hajajj	Hajajj
hajjaj_desc	This character has made the Hajj - the pilgrimage to Mecca.	This character has made the Hajj - the pilgrimage to Mecca.
on_hajj	On Hajj	On Hajj
on_hajj_desc	This character is on a pilgrimage to Mecca.	This character is on a pilgrimage to Mecca.
faqih	Faqih	Faqih
faqih_desc	This character is formally schooled in Islamic jurisprudence.	This character is formally schooled in Islamic jurisprudence.
hafiz	Hafiz	Hafiz
hafiz_desc	This character has completely memorized the Qur'an.	This character has completely memorized the Qur'an.
sayyid	Sayyid	Sayyid
sayyid_desc	This character is patrilineally descended from the Prophet Muhammad's uncles al-Abbas and Abu Talib, or from the sons of his daughter Fatimah - Hasan ibn Ali and Husain ibn Ali.	This character is patrilineally descended from the Prophet Muhammad's uncles al-Abbas and Abu Talib, or from the sons of his daughter Fatimah - Hasan ibn Ali and Husain ibn Ali.
mirza	Mirza	Mirza
mirza_desc	The mother of this character is a Sayyida (patrilineally descended from the Prophet Muhammad).	The mother of this character is a Sayyida (patrilineally descended from the Prophet Muhammad).
scarred	Scarred	Scarred
scarred_desc	Old wounds have left this character visibly scarred.	Old wounds have left this character visibly scarred.
pilgrim	Pilgrim	Pilgrim
pilgrim_desc	The character has completed a great pilgrimage.	The character has completed a great pilgrimage.
MUSLIM_VIEW	$TRAIT$: $VALUE$	$TRAIT$: $VALUE$
AIREASON_IS_HIGHER_RANK_SPOUSE	§Y[GetTitledFirstName]§! is my Spouse and higher ranked	§Y[GetTitledFirstName]§! is my Spouse and higher ranked
FIGHTING_ANOTHER_WAR	Busy fighting another war	§Y[GetTitledFirstName]§! must not marry an infidel
empire	Empire	Busy fighting another war
kingdom	Kingdom	Empire
duchy	Duchy	Kingdom
county	County	Duchy
barony	Barony	County
city_empire	Principality	Barony
city_kingdom	Most Serene Republic	Principality
city_duchy	Republic	Most Serene Republic
city_county	Grand City	Republic
city_barony	City	Grand City
temple_kingdom_catholic	Theocracy	City
temple_kingdom_orthodox	Patriarchate	Theocracy
temple_kingdom_muslim	Caliphate	Patriarchate
temple_kingdom_pagan_group	Theocracy	Caliphate
temple_duchy_christian	Prince-Archbishopric	Theocracy
temple_duchy_muslim	Theocracy	Prince-Archbishopric
temple_duchy_pagan_group	Theocracy	Theocracy
temple_county_christian	Prince-Bishopric	Theocracy
temple_county_muslim	Sheikhdom	Prince-Bishopric
temple_county_pagan_group	Theocracy	Sheikhdom
temple_barony_christian	Bishopric	Theocracy
temple_barony_muslim	Mosque	Bishopric
temple_barony_pagan_group	Temple	Mosque
count_arabic_female	Shaykhah	Temple
empire_altaic	Khaganate	Shaykhah
kingdom_altaic	Khanate	Khaganate
barony_arabic	Wilayah	Khanate
county_arabic	Sheikhdom	Wilayah
duchy_arabic	Emirate	Sheikhdom
kingdom_arabic	Sultanate	Emirate
barony_turkish	Timar	Sultanate
county_turkish	Beylik	Timar
duchy_turkish	Beylerbeylik	Beylik
kingdom_turkish	Sultanate	Beylerbeylik
barony_mongol	Taishi	Sultanate
county_mongol	Chiefdom	Taishi
duchy_mongol	High Chiefdom	Chiefdom
baron_west_african	Wâli	High Chiefdom
barony_of_west_african	Wilayah of	Wâli
barony_west_african	Wilayah	Wilayah of
count_west_african	Farin	Wilayah
count_female_west_african	Farina	Farin
county_of_west_african	Sheikhdom of	Farina
county_west_african	Sheikhdom	Sheikhdom of
duke_west_african	Farbas	Sheikhdom
duke_female_west_african	Farba	Farbas
duchy_of_west_african	Emirate of	Farba
duchy_west_african	Emirate	Emirate of
king_west_african	Mansa	Emirate
king_female_west_african	Sultana	Mansa
kingdom_of_west_african	Sultanate of	Sultana
kingdom_west_african	Sultanate	Sultanate of
#alert_high_decadence_instant	§YHigh Decadence§!	Sultanate
#alert_high_decadence_delayed	Your dynasty is seen as hopelessly decadent. There is a risk of a massive revolt.	§YHigh Decadence§!
PRETENDER_TO	Pretender and Claimant to the $TITLE$	Your dynasty is seen as hopelessly decadent. There is a risk of a massive revolt.
one_celibate	Pleasures in the after-life: Celibacy	Pretender and Claimant to the $TITLE$
one_hedonist	Pleasures in life: Hedonism	Pleasures in the after-life: Celibacy
opinion_adopted_foreign_ways	Adopted Foreign Ways	Pleasures in life: Hedonism
opinion_nomuslim	Not a True Believer	Adopted Foreign Ways
opinion_brother_muslim	My Brother	Not a True Believer
opinion_half_brother_muslim	My Half-Brother	My Brother
imam_appreciates	The Imams Approve	My Half-Brother
pious_imams	Money-loving Imams	The Imams Approve
unfunny_imam	Disregards Blasphemy	Money-loving Imams
NOT_ALLOWED_PLAY_LOWBORN	Not allowed to play §YLowborn§!	Disregards Blasphemy
NOT_ALLOWED_PLAY_LOWBORN_MP	§Y$PLAYER$§! not allowed to play §YLowborn§!	Not allowed to play §YLowborn§!
light_foot_leader	Light Foot Leader	§Y$PLAYER$§! not allowed to play §YLowborn§!
light_foot_leader_desc	This character has proven to be a capable commander when leading light infantry into battle.	Light Foot Leader
heavy_infantry_leader	Heavy Infantry Leader	This character has proven to be a capable commander when leading light infantry into battle.
heavy_infantry_leader_desc	This character is skilled at leading heavily armored infantry into battle.	Heavy Infantry Leader
cavalry_leader	Cavalry Leader	This character is skilled at leading heavily armored infantry into battle.
cavalry_leader_desc	This character excels at leading men to war on horseback.	Cavalry Leader
inspiring_leader	Inspiring Leader	This character excels at leading men to war on horseback.
inspiring_leader_desc	This character has a way of reaching directly into the hearts and minds of the soldiers on the battlefield, and not just with a sword.	Inspiring Leader
trickster	Trickster	This character has a way of reaching directly into the hearts and minds of the soldiers on the battlefield, and not just with a sword.
trickster_desc	This character is known to be an unpredictable element on the battlefield. The enemy won't see it coming, and neither will you!	Trickster
organizer	Organizer	This character is skilled at misdirection, and will often feint an attack from one direction only to suddenly charge from another.
organizer_desc	This character is a skillful organizer in matters of logistics and in overcoming the challenges of moving a large body of men from one point to another.	Organizer
defensive_leader	Defender	This character is a skillful organizer in matters of logistics and in overcoming the challenges of moving a large body of men from one point to another.
defensive_leader_desc	This character has a reputation as a stalwart defender, standing like a stone wall alongside the men no matter what force hurls itself against them.	Defender
#experimenter	Unpredictable Leader	This character has a reputation as a stalwart defender, standing like a stone wall alongside the men no matter what force hurls itself against them.
#experimenter_desc	This character is known to be an unpredictable element on the battlefield. The enemy won't see it coming, and neither will you!	Unpredictable Leader
flanker	Flanker	This character is known to be an unpredictable element on the battlefield. The enemy won't see it coming, and neither will you!
flanker_desc	This character fights best when positioned on the flank of an army, striking deeply at the chinks in the enemy's armor.	Flanker
aggressive_leader	Aggressive Leader	This character fights best when positioned on the flank of an army, striking deeply at the chinks in the enemy's armor.
aggressive_leader_desc	This character does not shy away from battle, and will show no mercy to opponents who attempt to quit the field.	Aggressive Leader
EVTDESC6071	The cough disappeared, thank [Root.Religion.GetRandomGodName]! I still feel a bit weak but the coughing, the chest pain and the shortness of breath are gone.	This character does not shy away from battle, and will show no mercy to opponents who attempt to quit the field.
EVTOPTD76041	Your father sinned when he fathered you	The cough disappeared, thank [Root.Religion.GetRandomGodName]! I still feel a bit weak but the coughing, the chest pain and the shortness of breath are gone.
EVTOPTB61146	[Root.Religion.GetRandomGodNameCap] help us when that [Root.Liege.GetLadLass] sits on the throne...	Your father sinned when he fathered you
EVTOPTB61226	By [Root.Religion.GetRandomGodName], ye shan't leave this field alive.	[Root.Religion.GetRandomGodNameCap] help us when that [Root.Liege.GetLadLass] sits on the throne...
EVTOPTB61223	By [Root.Religion.GetRandomGodName], what have I gotten myself into? I will have no part in this madness.	By [Root.Religion.GetRandomGodName], ye shan't leave this field alive.
EVTDESC7509	I assume this is yet another poor attempt at humor, my liege. I shan't surrender that which is rightfully mine, no matter who demands it, by [Root.Religion.GetRandomGodName]!\n\nSigned,\n[From.GetTitledName]	By [Root.Religion.GetRandomGodName], what have I gotten myself into? I will have no part in this madness.
EVTOPTB3636	A forkful of animal excrement!	I assume this is yet another poor attempt at humor, my liege. I shan't surrender that which is rightfully mine, no matter who demands it, by [Root.Religion.GetRandomGodName]!\n\nSigned,\n[From.GetTitledName]
EVTTOOLTIP3638	[Root.GetTitledFirstName] has choosen the weapon for the duel: a forkful of animal excrement	A forkful of animal excrement!
EVTDESC3638	I could not believe my ears when [From.GetTitledFirstName]'s second told me what kind of weapon we would use in the duel: a forkful of animal excrement!	[Root.GetTitledFirstName] has choosen the weapon for the duel: a forkful of animal excrement
EVTOPTB3638	I will not touch animal excrement!	I could not believe my ears when [From.GetTitledFirstName]'s second told me what kind of weapon we would use in the duel: a forkful of animal excrement!
EVTDESC3639	It came as no suprise to me when [From.GetTitledFirstName]'s second told me to bring my sword to the duel, I was just glad I didn't have to fight with a sledgehammer, or, [Root.Religion.GetName] forbide, something disgusting as animal excrement!	I will not touch animal excrement!
EVTNAME60100	The Mongols sack Kiev!	It came as no suprise to me when [From.GetTitledFirstName]'s second told me to bring my sword to the duel, I was just glad I didn't have to fight with a sledgehammer, or, [Root.Religion.GetName] forbide, something disgusting as animal excrement!
EVTDESC60100	The Mongol scourge has poured through the Golden Gates of Kiev and sacked the once proud trading hub. The city has been left a smoldering ruin and the Dnieper now runs red with the blood of its former inhabitants.	The Mongols sack Kiev!
EVTOPTA60100	Perhaps the stories were true...	The Mongol scourge has poured through the Golden Gates of Kiev and sacked the once proud trading hub. The city has been left a smoldering ruin and the Dnieper now runs red with the blood of its former inhabitants.
EVTNAME60101	The Mongols sack Novgorod!	Perhaps the stories were true...
EVTDESC60101	Novgorod has been stormed by the Tartar horde and both the city and its population are now suffering beyond measure. The Cathedral of Saint Sophia is engulfed in flames as the steppe warriors loot that which can be carried away and put the rest to the torch.	The Mongols sack Novgorod!
EVTOPTA60101	Perhaps their bloodlust has been sated now.	Novgorod has been stormed by the Tartar horde and both the city and its population are now suffering beyond measure. The Cathedral of Saint Sophia is engulfed in flames as the steppe warriors loot that which can be carried away and put the rest to the torch.
EVTNAME60102	The Mongols sack Krakow!	Perhaps their bloodlust has been sated now.
EVTDESC60102	The Mongols continue their push beyond the Vistula and into Poland. Krakow has now fallen to the invaders, and it is said that at night the flames from the burning city can be seen from untold leagues away.	The Mongols sack Krakow!
EVTOPTA60102	They must be stopped!	The Mongols continue their push beyond the Vistula and into Poland. Krakow has now fallen to the invaders, and it is said that at night the flames from the burning city can be seen from untold leagues away.
EVTNAME60103	The Mongols sack Aachen!	They must be stopped!
EVTDESC60103	Even Aachen, the former seat of Charlemagne's great Carolingian empire, has fallen under the shadow of the Mongol scourge. His spirit must surely be weeping at the atrocities now being committed within the city's walls.	The Mongols sack Aachen!
EVTOPTA60103	Barbarians!	Even Aachen, the former seat of Charlemagne's great Carolingian empire, has fallen under the shadow of the Mongol scourge. His spirit must surely be weeping at the atrocities now being committed within the city's walls.
EVTNAME60104	The Mongols sack Paris!	Barbarians!
EVTDESC60104	Like a swarm of locusts, the unstoppable Mongols have descended upon Paris and sacked the city. The still unfinished Notre Dame Cathedral is quickly set on fire and with the light provided by the rest of the burning city, the Mongol warriors can continue looting and murdering well into the night.	The Mongols sack Paris!
EVTOPTA60104	There seems to be no reprieve from these accursed Tartars.	Like a swarm of locusts, the unstoppable Mongols have descended upon Paris and sacked the city. The still unfinished Notre Dame Cathedral is quickly set on fire and with the light provided by the rest of the burning city, the Mongol warriors can continue looting and murdering well into the night.
EVTNAME60105	The Mongols sack London!	There seems to be no reprieve from these accursed Tartars.
EVTDESC60105	Not even the sea has proved a formidable enough barrier to halt the Mongol advance. London has fallen to their vanguard and the city is now the scene of a slaughter on a scale unrivaled since the days of Queen Boudica and her rebellion. 	The Mongols sack London!
EVTOPTA60105	God save us all.	Not even the sea has proved a formidable enough barrier to halt the Mongol advance. London has fallen to their vanguard and the city is now the scene of a slaughter on a scale unrivaled since the days of Queen Boudica and her rebellion. 
EVTNAME60106	The Mongols sack Rome!	God save us all.
EVTDESC60106	Once more Rome suffers at the cruel hands of eastern barbarians. The Mongols have breached the Aurelian Walls, and their horses are now grazing on the field of the Circus Maximus while they raise their yurts on the Palatine Hill. As expected, no mercy is shown to those Romans who have not yet fled the city.	The Mongols sack Rome!
EVTOPTA60106	Is this the end of days?	Once more Rome suffers at the cruel hands of eastern barbarians. The Mongols have breached the Aurelian Walls, and their horses are now grazing on the field of the Circus Maximus while they raise their yurts on the Palatine Hill. As expected, no mercy is shown to those Romans who have not yet fled the city.
EVTNAME60107	The Mongols sack Venice!	Is this the end of days?
EVTDESC60107	The canals of Venice have been blocked by the bloated corpses of the dead as the city is sacked by frenzied Mongol warriors. Those few fortunate enough to have escaped the slaughter claim the bodies are packed tightly enough in the Venetian Lagoon for the Mongols to ride to and from the mainland as they please.	The Mongols sack Venice!
EVTOPTA60107	Surely that can't be true!	The canals of Venice have been blocked by the bloated corpses of the dead as the city is sacked by frenzied Mongol warriors. Those few fortunate enough to have escaped the slaughter claim the bodies are packed tightly enough in the Venetian Lagoon for the Mongols to ride to and from the mainland as they please.
EVTNAME60108	The Mongols sack Constantinople!	Surely that can't be true!
EVTDESC60108	The Theodosian Walls have not been enough to spare Constantinople from the vile touch of the Tartar scourge. The great imperial capital has been sacked, its citizens butchered or enslaved, the Hagia Sophia defiled and the Great Palace of the emperors put to the torch.	The Mongols sack Constantinople!
EVTOPTA60108	May God have mercy on their souls.	The Theodosian Walls have not been enough to spare Constantinople from the vile touch of the Tartar scourge. The great imperial capital has been sacked, its citizens butchered or enslaved, the Hagia Sophia defiled and the Great Palace of the emperors put to the torch.
EVTNAME60109	The Mongols sack Lisbon!	May God have mercy on their souls.
EVTDESC60109	The Mongols have now reached as far west as Lisbon in their conquests. While the city burns at their touch, the steppe warriors look out over the great blue expanse of the Atlantic. Who can tell where they will turn next?	The Mongols sack Lisbon!
EVTOPTA60109	Is there no place beyond their reach?	The Mongols have now reached as far west as Lisbon in their conquests. While the city burns at their touch, the steppe warriors look out over the great blue expanse of the Atlantic. Who can tell where they will turn next?
EVTNAME60110	The Mongols sack Smolensk!	Is there no place beyond their reach?
EVTDESC60110	Smolensk has been swallowed up by the Mongol hordes as they continue their relentless advance to the west. When the great host finally moves on, little remains of the city but ashes and charred rubble, and those lucky few inhabitants who somehow escaped the notice of the rampaging horsemen.	The Mongols sack Smolensk!
EVTOPTA60110	Such butchery will not go unpunished.	Smolensk has been swallowed up by the Mongol hordes as they continue their relentless advance to the west. When the great host finally moves on, little remains of the city but ashes and charred rubble, and those lucky few inhabitants who somehow escaped the notice of the rampaging horsemen.
EVTNAME60111	The Mongols sack Prague!	Such butchery will not go unpunished.
EVTDESC60111	The city of Prague has become a beacon of light in an otherwise dark world, as the Mongol barbarians move from house to house and set fire to everything not yet looted. A flood of refugees spread horrific tales about the cruelty of the bloodthirsty Tartar horsemen to every corner of Europe.	The Mongols sack Prague!
EVTOPTA60111	Have they no regard for culture?	The city of Prague has become a beacon of light in an otherwise dark world, as the Mongol barbarians move from house to house and set fire to everything not yet looted. A flood of refugees spread horrific tales about the cruelty of the bloodthirsty Tartar horsemen to every corner of Europe.
EVTNAME60112	The Mongols sack Vienna!	Have they no regard for culture?
EVTDESC60112	Vienna, a city of growing importance on the Danube river, has become the latest victim of the Mongol hordes as they continue to pillage and burn their way across Europe. The smoking ruins and arrow-riddled corpses they leave behind when they move on do not lend much faith in the city's future prospects.	The Mongols sack Vienna!
EVTOPTA60112	There will come a time of reckoning.	Vienna, a city of growing importance on the Danube river, has become the latest victim of the Mongol hordes as they continue to pillage and burn their way across Europe. The smoking ruins and arrow-riddled corpses they leave behind when they move on do not lend much faith in the city's future prospects.
EVTNAME60113	The Mongols sack Esztergom!	There will come a time of reckoning.
EVTDESC60113	The Mongols have reached beyond the Carpathians and fanned out across the Great Hungarian Plain. Now the city of Esztergom has fallen to the murderous host and is the scene of indiscriminate slaughter. Those that attempt to flee on foot are cut down without mercy by the fast horsemen as dark, billowing smoke rises towards the sky above the city.	The Mongols sack Esztergom!
EVTOPTA60113	May it be the last city the Tartars take!	The Mongols have reached beyond the Carpathians and fanned out across the Great Hungarian Plain. Now the city of Esztergom has fallen to the murderous host and is the scene of indiscriminate slaughter. Those that attempt to flee on foot are cut down without mercy by the fast horsemen as dark, billowing smoke rises towards the sky above the city.
EVTNAME60114	The Mongols sack Athens!	May it be the last city the Tartars take!
EVTDESC60114	The ancient city of Athens has fallen to the Mongols, and they now rampage unchecked behind its walls. Great monuments and artifacts dating back to the dawn of Western Civilisation are lost forever in a cultural desecration that will surely be felt by future generations thousands of years from now.	The Mongols sack Athens!
EVTOPTA60114	This time they have gone too far!	The ancient city of Athens has fallen to the Mongols, and they now rampage unchecked behind its walls. Great monuments and artifacts dating back to the dawn of Western Civilisation are lost forever in a cultural desecration that will surely be felt by future generations thousands of years from now.
EVTNAME60115	The Mongols sack Belgrade!	This time they have gone too far!
EVTDESC60115	The "White City" has turned red as the Mongol invaders seize Belgrade and massacre the inhabitants without exception. After several days of slaughter and looting, the smell of death and rotting flesh proves too much even for the Mongols to bear and they move their camp upwind from the scorched ruins of the city.	The Mongols sack Belgrade!
EVTOPTA60115	They will be the end of us all!	The "White City" has turned red as the Mongol invaders seize Belgrade and massacre the inhabitants without exception. After several days of slaughter and looting, the smell of death and rotting flesh proves too much even for the Mongols to bear and they move their camp upwind from the scorched ruins of the city.
opinion_refused_abdicate_title	Refused to abdicate title	They will be the end of us all!
plot_gain_indie_title_title	Fabricate a claim on the [This.GetFullBaseName]	Refused to abdicate title
plot_gain_indie_title_desc	Rally support amongst the vassals of [This.Holder.GetTitledName] in an attempt to fabricate a claim on the [This.GetFullBaseName]. God willing, you may some day become their new liege.	Fabricate a claim on the [This.GetFullBaseName]
plot_gain_indie_title_decision_100	[Root.GetPlot]	Rally support amongst the vassals of [This.Holder.GetTitledName] in an attempt to fabricate a claim on the [This.GetFullBaseName]. God willing, you may some day become their new liege.
plot_gain_indie_title_decision_100_desc	Put the plot into motion by attempting to fabricate a claim on the [Root.PlotTargetTitle.GetFullBaseName].	[Root.GetPlot]
plot_gain_indie_title_decision_75	[Root.GetPlot]	Put the plot into motion by attempting to fabricate a claim on the [Root.PlotTargetTitle.GetFullBaseName].
plot_gain_indie_title_decision_75_desc	Put the plot into motion by attempting to fabricate a claim on the [Root.PlotTargetTitle.GetFullBaseName].	[Root.GetPlot]
plot_gain_liege_title_title	Fabricate a claim on the [This.GetFullBaseName]	Put the plot into motion by attempting to fabricate a claim on the [Root.PlotTargetTitle.GetFullBaseName].
plot_gain_liege_title_desc	Rally support amongst the other vassals of [This.Holder.GetTitledName] in an attempt to fabricate a claim on the [This.GetFullBaseName]. God willing, you may some day become their new liege.	Fabricate a claim on the [This.GetFullBaseName]
plot_gain_liege_title_decision_100	[Root.GetPlot]	Rally support amongst the other vassals of [This.Holder.GetTitledName] in an attempt to fabricate a claim on the [This.GetFullBaseName]. God willing, you may some day become their new liege.
plot_gain_liege_title_decision_100_desc	Put the plot into motion by attempting to fabricate a claim on the [Root.PlotTargetTitle.GetFullBaseName].	[Root.GetPlot]
plot_gain_liege_title_decision_75	[Root.GetPlot]	Put the plot into motion by attempting to fabricate a claim on the [Root.PlotTargetTitle.GetFullBaseName].
plot_gain_liege_title_decision_75_desc	Put the plot into motion by attempting to fabricate a claim on the [Root.PlotTargetTitle.GetFullBaseName].	[Root.GetPlot]
plot_gain_fellow_vassal_title_title	Fabricate a claim on the [This.GetFullBaseName]	Put the plot into motion by attempting to fabricate a claim on the [Root.PlotTargetTitle.GetFullBaseName].
plot_gain_fellow_vassal_title_desc	Rally support amongst the other vassals of [This.Holder.Liege.GetTitledName] in an attempt to fabricate a claim on the [This.GetFullBaseName]. God willing, you may some day rightfully take the title from [This.Holder.GetTitledFirstName].	Fabricate a claim on the [This.GetFullBaseName]
plot_gain_fellow_vassal_title_decision_100	[Root.GetPlot]	Rally support amongst the other vassals of [This.Holder.Liege.GetTitledName] in an attempt to fabricate a claim on the [This.GetFullBaseName]. God willing, you may some day rightfully take the title from [This.Holder.GetTitledFirstName].
plot_gain_fellow_vassal_title_decision_100_desc	Put the plot into motion by attempting to fabricate a claim on the [Root.PlotTargetTitle.GetFullBaseName].	[Root.GetPlot]
plot_gain_fellow_vassal_title_decision_75	[Root.GetPlot]	Put the plot into motion by attempting to fabricate a claim on the [Root.PlotTargetTitle.GetFullBaseName].
plot_gain_fellow_vassal_title_decision_75_desc	Put the plot into motion by attempting to fabricate a claim on the [Root.PlotTargetTitle.GetFullBaseName].	[Root.GetPlot]
EVTTOOLTIP7600	successfully fabricating a claim.	Put the plot into motion by attempting to fabricate a claim on the [Root.PlotTargetTitle.GetFullBaseName].
EVTTOOLTIP7601	failing to fabricate a claim.	successfully fabricating a claim.
EVTDESC7600	With the aid of your fellow conspirators, you have managed to fabricate a claim on the [Root.PlotTargetTitle.GetFullBaseName].	failing to fabricate a claim.
EVTOPTA7600	Excellent.	With the aid of your fellow conspirators, you have managed to fabricate a claim on the [Root.PlotTargetTitle.GetFullBaseName].
EVTDESC7601	Not only have you failed to fabricate a claim on the [Root.PlotTargetTitle.GetFullBaseName], but your efforts have been discovered. [Root.PlotTarget.GetTitledFirstName] is none too pleased...	Excellent.
EVTOPTA7601	This will take some explaining...	Not only have you failed to fabricate a claim on the [Root.PlotTargetTitle.GetFullBaseName], but your efforts have been discovered. [Root.PlotTarget.GetTitledFirstName] is none too pleased...
#ca_culture_group_north_germanic_1	Small Housecarl Training Ground	This will take some explaining...
#ca_culture_group_north_germanic_2	Housecarl Training Ground	Small Housecarl Training Ground
#ca_culture_group_north_germanic_3	Large Housecarl Training Ground	Housecarl Training Ground
#ca_culture_group_north_germanic_4	Great Housecarl Training Ground	Large Housecarl Training Ground
ca_culture_group_north_germanic_1	Housecarl Training Ground	Great Housecarl Training Ground
ca_culture_group_north_germanic_2	Housecarl Training Ground	Housecarl Training Ground
ca_culture_group_north_germanic_3	Housecarl Training Ground	Housecarl Training Ground
ca_culture_group_north_germanic_4	Housecarl Training Ground	Housecarl Training Ground
#ca_culture_hungarian_1	Small Hussar Training Ground	Housecarl Training Ground
#ca_culture_hungarian_2	Hussar Training Ground	Small Hussar Training Ground
#ca_culture_hungarian_3	Large Hussar Training Ground	Hussar Training Ground
#ca_culture_hungarian_4	Great Hussar Training Ground	Large Hussar Training Ground
ca_culture_hungarian_1	Hussar Training Ground	Great Hussar Training Ground
ca_culture_hungarian_2	Hussar Training Ground	Hussar Training Ground
ca_culture_hungarian_3	Hussar Training Ground	Hussar Training Ground
ca_culture_hungarian_4	Hussar Training Ground	Hussar Training Ground
#ca_culture_group_arabic_1	Small Camel Riding Ground	Hussar Training Ground
#ca_culture_group_arabic_2	Camel Riding Ground	Small Camel Riding Ground
#ca_culture_group_arabic_3	Large Camel Riding Ground	Camel Riding Ground
#ca_culture_group_arabic_4	Great Camel Riding Ground	Large Camel Riding Ground
ca_culture_group_arabic_1	Camel Riding Ground	Great Camel Riding Ground
ca_culture_group_arabic_2	Camel Riding Ground	Camel Riding Ground
ca_culture_group_arabic_3	Camel Riding Ground	Camel Riding Ground
ca_culture_group_arabic_4	Camel Riding Ground	Camel Riding Ground
#ca_culture_group_byzantine_1	Small Cataphract Training Ground	Camel Riding Ground
#ca_culture_group_byzantine_2	Cataphract Training Ground	Small Cataphract Training Ground
#ca_culture_group_byzantine_3	Large Cataphract Training Ground	Cataphract Training Ground
#ca_culture_group_byzantine_4	Great Cataphract Training Ground	Large Cataphract Training Ground
ca_culture_group_byzantine_1	Cataphract Training Ground	Great Cataphract Training Ground
ca_culture_group_byzantine_2	Cataphract Training Ground	Cataphract Training Ground
ca_culture_group_byzantine_3	Cataphract Training Ground	Cataphract Training Ground
ca_culture_group_byzantine_4	Cataphract Training Ground	Cataphract Training Ground
#ca_culture_irish_1	Small Gallowglass Training Ground	Cataphract Training Ground
#ca_culture_irish_2	Gallowglass Training Ground	Small Gallowglass Training Ground
#ca_culture_irish_3	Large Gallowglass Training Ground	Gallowglass Training Ground
#ca_culture_irish_4	Great Gallowglass Training Ground	Large Gallowglass Training Ground
ca_culture_irish_1	Gallowglass Training Ground	Great Gallowglass Training Ground
ca_culture_irish_2	Gallowglass Training Ground	Gallowglass Training Ground
ca_culture_irish_3	Gallowglass Training Ground	Gallowglass Training Ground
ca_culture_irish_4	Gallowglass Training Ground	Gallowglass Training Ground
#ca_culture_ethiopian_1	Small Ethiopian Drilling Grounds	Gallowglass Training Ground
#ca_culture_ethiopian_2	Ethiopian Drilling Grounds	Small Ethiopian Drilling Grounds
#ca_culture_ethiopian_3	Large Ethiopian Drilling Grounds	Ethiopian Drilling Grounds
#ca_culture_ethiopian_4	Great Ethiopian Drilling Grounds	Large Ethiopian Drilling Grounds
ca_culture_ethiopian_1	Ethiopian Drilling Grounds	Great Ethiopian Drilling Grounds
ca_culture_ethiopian_2	Ethiopian Drilling Grounds	Ethiopian Drilling Grounds
ca_culture_ethiopian_3	Ethiopian Drilling Grounds	Ethiopian Drilling Grounds
ca_culture_ethiopian_4	Ethiopian Drilling Grounds	Ethiopian Drilling Grounds
#ca_culture_group_south_slavic_1	Small Gusar Training Ground	Ethiopian Drilling Grounds
#ca_culture_group_south_slavic_2	Gusar Training Ground	Small Gusar Training Ground
#ca_culture_group_south_slavic_3	Large Gusar Training Ground	Gusar Training Ground
#ca_culture_group_south_slavic_4	Great Gusar Training Ground	Large Gusar Training Ground
ca_culture_group_south_slavic_1	Gusar Training Ground	Great Gusar Training Ground
ca_culture_group_south_slavic_2	Gusar Training Ground	Gusar Training Ground
ca_culture_group_south_slavic_3	Gusar Training Ground	Gusar Training Ground
ca_culture_group_south_slavic_4	Gusar Training Ground	Gusar Training Ground
#ca_culture_dutch_1	Small Goedendag Militia Quarters	Gusar Training Ground
#ca_culture_dutch_2	Goedendag Militia Quarters	Small Goedendag Militia Quarters
#ca_culture_dutch_3	Large Goedendag Militia Quarters	Goedendag Militia Quarters
#ca_culture_dutch_4	Great Goedendag Militia Quarters	Large Goedendag Militia Quarters
ca_culture_dutch_1	Goedendag Militia Quarters	Great Goedendag Militia Quarters
ca_culture_dutch_2	Goedendag Militia Quarters	Goedendag Militia Quarters
ca_culture_dutch_3	Goedendag Militia Quarters	Goedendag Militia Quarters
ca_culture_dutch_4	Goedendag Militia Quarters	Goedendag Militia Quarters
d_sunni	The Sunni Caliphate	Goedendag Militia Quarters
d_sunni_adj	Caliphal	The Sunni Caliphate
d_shiite	The Shia Caliphate	Caliphal
d_shiite_adj	Caliphal	The Shia Caliphate
k_dacia	Wallachia	Caliphal
k_dacia_adj	Wallachian	Wallachia
b_sijilmasa	Sijilmasa	Wallachian
b_merzouga	Merzouga	Sijilmasa
b_tanamouste	Tanamouste	Merzouga
b_ertoud	Ertoud	Tanamouste
b_merzane	Merzane	Ertoud
b_hannabou	Hannabou	Merzane
b_tadaout	Tadaout	Hannabou
b_tisserdmine	Tisserdmine	Tadaout
k_mali	Mali	Tisserdmine
e_mali	Mali	Mali
d_armenia_minor_adj_armenian	Armenian	Mali
e_abyssinia	Abyssinia	Armenian
e_abyssinia_adj	Abyssinian	Abyssinia
d_timbuktu	Timbuktu	Abyssinian
b_timbuktu	Timbuktu	Timbuktu
b_alafia	Alafia	Timbuktu
b_salam	Salam	Alafia
b_lafia	Lafia	Salam
b_ber	Ber	Lafia
b_boureminaly	Bourem-Inaly	Ber
b_toya	Toya	Bourem-Inaly
b_aglal	Aglal	Toya
b_oualata	Oualata	Aglal
b_tiguiguil	Tiguiguil	Oualata
b_neiguiat	Neïguiat	Tiguiguil
b_konou	Konou	Neïguiat
b_birnsara	Bir Nsara	Konou
b_tizert	Tizert	Bir Nsara
b_tarhalet	Tarhalet	Tizert
b_fassekra	Fassekra	Tarhalet
b_araouane	Araouane	Fassekra
b_tessalit	Tessalit	Araouane
b_aguelhok	Aguelhok	Tessalit
b_abalessa	Abalessa	Aguelhok
b_tinzaouten	Tinzaouten	Abalessa
b_guezzam	Guezzam	Tinzaouten
b_tamanrasset	Tamanrasset	Guezzam
b_tazrouk	Tazrouk	Tamanrasset
b_taghaza	Taghaza	Tazrouk
b_kerzaz	Kerzaz	Taghaza
b_metarta	Metarta	Kerzaz
b_reggane	Reggane	Metarta
b_adrar	Adrar	Reggane
b_aougrout	Aougrout	Adrar
b_charouine	Charouine	Aougrout
b_alouarta	El Ouarta	Charouine
d_ghana	Ghana	El Ouarta
b_el_ghaba	El Ghaba	Ghana
b_koumbi_saleh	Koumbi Saleh	El Ghaba
b_silla	Silla	Koumbi Saleh
b_singhanah	Singhanah	Silla
b_samakanda	Sámakanda	Singhanah
b_ras_elma	Ras el Má	Sámakanda
b_tirka	Tírka	Ras el Má
b_kughah	Kúghah	Tírka
b_aoudaghost	Aoudaghost	Kúghah
b_tichitt	Tichitt	Aoudaghost
b_moudjeria	Moudjeria	Tichitt
b_ksarelbarka	Ksar-el-Barka	Moudjeria
b_ouadane	Ouadane	Ksar-el-Barka
b_wadan	Wadan	Ouadane
b_azuggi	Azuggi	Wadan
b_ksaralkiali	Ksar-al-Kiali	Azuggi
b_idjil	Idjil	Ksar-al-Kiali
b_zouerat	Zouérat	Idjil
b_tazadit	Tazadit	Zouérat
b_rouessa	Rouessa	Tazadit
b_fderick	Fdérick	Rouessa
d_mali	Mali	Fdérick
b_boure	Boure	Mali
b_niani	Niani	Boure
b_bamako	Bamako	Niani
b_safo	Safo	Bamako
b_baguineda	Baguineda	Safo
b_dialakoro	Dialakoro	Baguineda
b_bougouni	Bougouni	Dialakoro
b_soussa	Soussa	Bougouni
b_bambuk	Bambuk	Soussa
b_kiffa	Kiffa	Bambuk
b_kankossa	Kankossa	Kiffa
b_boumdeid	Boumdeid	Kankossa
b_guerou	Guerou	Boumdeid
b_aftout	Aftout	Guerou
b_djenne	Djenne	Aftout
b_macina	Macina	Djenne
b_fakala	Fakala	Macina
b_kewa	Kewa	Fakala
b_ouroali	Ouro Ali	Kewa
b_pondori	Pondori	Ouro Ali
b_femaye	Femaye	Pondori
b_derary	Derary	Femaye
d_songhay	Songhay	Derary
b_gao	Gao	Songhay
b_sarnah	Sarnah	Gao
b_gaosaney	Gao-Saney	Sarnah
b_bourem	Bourem	Gao-Saney
b_ansongo	Ansongo	Bourem
b_menaka	Ménaka	Ansongo
b_gabero	Gabero	Ménaka
b_anchawadi	Anchawadi	Gabero
b_tadmekka	Tadmekka	Anchawadi
b_agades	Agades	Tadmekka
b_takedda	Takedda	Agades
b_essako	Essako	Takedda
b_kidal	Kidal	Essako
c_gurma	Gurma	Kidal
c_gurma_adj	Gurman	Gurma
b_gurma	Gurma	Gurman
b_zorgho	Zorgho	Gurma
b_hounde	Houndé	Zorgho
c_zarma	Zarma	Houndé
c_zarma_adj	Zarman	Zarma
b_bura	Bura	Zarman
b_ouallam	Ouallam	Bura
b_tera	Téra	Ouallam
d_susa	Susa	Téra
d_susa_adj	Susan	Susa
d_latium	Latium	Susan
d_latium_adj	Latin	Latium
c_aprutium_adj	Aprutian	Latin
b_foligno	Foligno	Aprutian
b_avezzano	Avezzano	Foligno
b_pescara	Pescara	Avezzano
b_teramo	Teramo	Pescara
b_atri	Atri	Teramo
b_aprutium_penne	Penne	Atri
b_ciconia	Ciconia	Penne
b_paganica	Paganica	Ciconia
ANY_POT_TRIBAL_COUNTY_STARTS	Any Potential Tribal County	Paganica
ALL_POT_TRIBAL_COUNTY_STARTS	All Potential Tribal Counties	Any Potential Tribal County
ANY_TRAIT_HOLDER_STARTS	Any Character with trait 	All Potential Tribal Counties
REVOKE_TITLE_INTERACTION_2F	Our Imperial administration allows us to revoke Duchies without objections from the aristocracy.	Any Character with trait 
DISTANCE_LESS_THAN	Distance less than 	Our Imperial administration allows us to revoke Duchies without objections from the aristocracy.
DISTANCE_AT_LEAST	Distance at least 	Distance less than 
RANDOM_ROLL_LESS_THAN	Random Roll less than 	Distance at least 
RANDOM_ROLL_AT_LEAST	Random Roll at least 	Random Roll less than 
EVTOPTD37055	You are already married, remember? To [From.Spouse.GetTitledFirstName]?	Random Roll at least 
opinion_sadaqah	Gave Sadaqah	You are already married, remember? To [From.Spouse.GetTitledFirstName]?
reckless_charge_tactic	Reckless Charge Tactic	Gave Sadaqah
timid_advance_tactic	Timid Advance Tactic	Reckless Charge Tactic
confused_orders_tactic	Confused Orders	Timid Advance Tactic
hesitant_commander_tactic	Hesitant Commander	Confused Orders
charging_own_skirmishers_tactic	Charging Through Own Skirmishers	Hesitant Commander
inspired_defense_tactic	Inspired Defense Tactic	Charging Through Own Skirmishers
heroic_countercharge_tactic	Heroic Counter-Charge Tactic	Inspired Defense Tactic
clever_ambush_tactic	Clever Ambush Tactic	Heroic Counter-Charge Tactic
religious_fervour_tactic	Gripped by Religious Fervour	Clever Ambush Tactic
retreat_and_ambush_tactic	Retreat and Ambush Tactic	Gripped by Religious Fervour
berserker_charge_tactic	Berserker Charge	Retreat and Ambush Tactic
schiltron_formation_tactic	Schiltron Formation	Berserker Charge
pike_column_advance_tactic	Pike Column Advance	Schiltron Formation
massive_longbow_volley_tactic	Massive Longbow Volley Tactic	Pike Column Advance
couched_lance_charge_tactic	Couched Lance Charge	Massive Longbow Volley Tactic
desert_ambush_tactic	Desert Ambush	Couched Lance Charge
embolon_charge_formation_tactic	Embolon Charge Formation	Desert Ambush
muslim_hedonist	Tasting the forbidden wine of Hedonism	Embolon Charge Formation
muslim_poet	Making the world more poetic	Tasting the forbidden wine of Hedonism
DECADENCE_MOD	Decadence	Making the world more poetic
CURRENT_DECADENCE	Current	Decadence
EFFECTS	Effects	Current
DEMESNE_INCOME	Demesne Income	Effects
MONTHLY_COMBAT_DEC_CHANGE	Change due to combat this month	Demesne Income
BATTLES	Battles	Change due to combat this month
MONTHLY_UNLANDED	§YChange due to jobless sons:§!	Battles
DYNASTIC_DECADENCE	Dynastic Decadence	§YChange due to jobless sons:§!
JOBLESS_SON	 ( $NUM_SONS$ jobless son )	Dynastic Decadence
JOBLESS_SONS	 ( $NUM_SONS$ jobless sons )	 ( $NUM_SONS$ jobless son )
REL_FIRSTWIFE	First Wife	 ( $NUM_SONS$ jobless sons )
MUSLIM_TAX_PENALTY	Lack of Jizya Tax Penalty: 	First Wife
JIZYA_BONUS	Jizya Tax Bonus: 	Lack of Jizya Tax Penalty: 
claim_all_desc	§Y$CLAIMANT$§! can declare war on §Y$TARGET$§! with several strong claims (weak claims do not count.)	Jizya Tax Bonus: 
alert_can_press_weak_claims_instant	§Y$NUM$ Weak Claim(s) can be pressed§!	§Y$CLAIMANT$§! can declare war on §Y$TARGET$§! with several strong claims (weak claims do not count.)
alert_can_press_weak_claims_delayed	The following Weak Claims can be pressed:\n$LIST$	§Y$NUM$ Weak Claim(s) can be pressed§!
MORALE_DEMESNE_TROOPS	Morale of Demesne Troops	The following Weak Claims can be pressed:\n$LIST$
HAS_LOWER_DECADENCE_THAN	Has a lower Decadence than 	Morale of Demesne Troops
HAS_HIGHER_DECADENCE_THAN	Has a Decadence of at least 	Has a lower Decadence than 
DECADENCE_EFFECT	$DIRECTION$ $VALUE$ decadence.\n	Has a Decadence of at least 
DESTROY	Destroy	$DIRECTION$ $VALUE$ decadence.\n
TITLE_DESTROYED_SETUP	Title Destroyed	Destroy
TITLE_DESTROYED_LOG	§Y$DESTROYER$§! has destroyed the title §Y$TITLE$§!.	Title Destroyed
CHAR_REL_DIVORCED_SETUP	Divorce Granted	§Y$DESTROYER$§! has destroyed the title §Y$TITLE$§!.
CHAR_REL_DIVORCED_LETTER	Dear $SPOUSE$, our marriage just is not working anymore. Therefore, §Y$REL_HEAD$§! has graciously granted us a divorce.\n\n$ACTOR$	Divorce Granted
CHAR_REL_DIVORCED_LOG	§Y$REL_HEAD$§! has granted §Y$ACTOR$§! a divorce from §Y$VICTIM$§!.	Dear $SPOUSE$, our marriage just is not working anymore. Therefore, §Y$REL_HEAD$§! has graciously granted us a divorce.\n\n$ACTOR$
CHAR_DIVORCED_SETUP	Divorce Arranged	§Y$REL_HEAD$§! has granted §Y$ACTOR$§! a divorce from §Y$VICTIM$§!.
CHAR_DIVORCED_LETTER	Dear $SPOUSE$, our marriage just is not working anymore. Therefore, I have decided to divorce you. Sorry.\n\n$ACTOR$	Divorce Arranged
CHAR_DIVORCED_LOG	§Y$ACTOR$§! has divorced §Y$VICTIM$§!	Dear $SPOUSE$, our marriage just is not working anymore. Therefore, I have decided to divorce you. Sorry.\n\n$ACTOR$
CONFIRM_TITLE_DESTRUCTION	Destroy the title of the $TITLE$?	§Y$ACTOR$§! has divorced §Y$VICTIM$§!
TITLE_DESTRUCTION_COST_DESC	Destroying this title would cost you §R$PRESTIGE$§! Prestige. All de jure vassals of the $TITLE$ will be upset (§R$OPINION$§! Opinion).	Destroy the title to the $TITLE$?
opinion_destroyed_dj_liege_title	Destroyed Liege Title	Destroying this title would cost you §R$PRESTIGE$§! Prestige. All de jure vassals of the $TITLE$ will be upset (§R$OPINION$§! Opinion).
CANNOT_DESTROY_BELOW_DUKE	Cannot destroy counties or baronies	Destroyed Liege Title
CANNOT_DESTROY_PRIMARY_TITLE	Cannot destroy your primary title	Cannot destroy counties or baronies
CANNOT_DESTROY_SPECIAL_TITLE	Cannot destroy special title	Cannot destroy your primary title
CANNOT_AFFORD_DESTRUCTION	Must have §R$PRESTIGE$§! Prestige	Cannot destroy special title
DOES_NOT_HAVE_REGENT	Does NOT have a Regent	Must have §R$PRESTIGE$§! Prestige
HAS_REGENT	Has a Regent	Does NOT have a Regent
ISNT_CONTESTED_TITLE	Is NOT being contested by claimants	Has a Regent
IS_CONTESTED_TITLE	Is being contested by claimants	Is NOT being contested by claimants
STRONG_CLAIM_TITLE	§YStrong Claim on the $TITLE$§W	Is being contested by claimants
WEAK_CLAIM_TITLE	§YWeak Claim on the $TITLE$§W	§YStrong Claim on the $TITLE$§W
STRONG_CLAIM_DESC	On succession, Strong Claims are only given to children who are second or third in the line of succession.	§YWeak Claim on the $TITLE$§W
WEAK_CLAIM_DESC	On succession, Weak Claims are given to children who are not second or third in the line of succession. Weak Claims can only be pressed against:\n§Y* Female Rulers if the claimant is male\n* Regencies\n* Titles already being contested in a Claim or Succession War\n* Titles the claimant is second or third in line to inherit§!	On succession, Strong Claims are only given to children who are second or third in the line of succession.
HAS_NOT_STRONG_CLAIM	Does NOT have a Strong Claim on $TITLE$	On succession, Weak Claims are given to children who are not second or third in the line of succession. Weak Claims can only be pressed against:\n§Y* Female Rulers if the claimant is male\n* Regencies\n* Titles already being contested in a Claim or Succession War\n* Titles the claimant is second or third in line to inherit§!
HAS_STRONG_CLAIM	Has Strong Claim on $TITLE$	Does NOT have a Strong Claim on $TITLE$
HAS_NOT_WEAK_CLAIM	Does NOT have a Weak Claim on $TITLE$	Has Strong Claim on $TITLE$
HAS_WEAK_CLAIM	Has Weak Claim on $TITLE$	Does NOT have a Weak Claim on $TITLE$
GAIN_CLAIM_ON	$WHO$ gets a Strong Claim on §Y$TITLE$§!.\n	Has Weak Claim on $TITLE$
GAIN_WEAK_CLAIM_ON	$WHO$ gets a Weak Claim on §Y$TITLE$§!.\n	$WHO$ gets a Strong Claim on §Y$TITLE$§!.\n
iddah_period	Iddah Period	$WHO$ gets a Weak Claim on §Y$TITLE$§!.\n
opinion_chief_qadi	Chief Qadi	Iddah Period
opinion_merciful_qadi	Merciful Chief Qadi	Chief Qadi
opinion_arbitrary_qadi	Arbitrary Chief Qadi	Merciful Chief Qadi
#LAW_NORMAL_CHANGE_MUSLIM_PIETY_COST	It costs $PIETY$ $PIETYNAME$ for Muslims to change Demesne Laws	Arbitrary Chief Qadi
#LAW_DE_JURE_CHANGE_MUSLIM_PIETY_COST	It costs $PIETY$ $PIETYNAME$ for Muslims to change Crown Laws	It costs $PIETY$ $PIETYNAME$ for Muslims to change Demesne Laws
CB_NAME_COUNTY_CONQUEST	Conquest of [Title.GetBaseName]	It costs $PIETY$ $PIETYNAME$ for Muslims to change Crown Laws
WAR_NAME_COUNTY_CONQUEST	$ORDER$$FIRST_ADJ$ Conquest of $OTHER_TITLE$	Conquest of [Title.GetBaseName]
EVTTOOLTIPB3538	[Root.GetTitledFirstName] has nothing but contempt for [This.GetTitledFirstName]'s idiotic flagellation	$ORDER$$FIRST_ADJ$ Conquest of $OTHER_TITLE$
EVTDESC55000	The [Root.Culture.GetName] populace in [Root.GetName] have embraced [Root.Holder.Culture.GetName] culture.	[Root.GetTitledFirstName] has nothing but contempt for [This.GetTitledFirstName]'s idiotic flagellation
EVTDESC55001	The [Root.Culture.GetName] populace in [Root.GetName] resent me as a ruler and feel that I am a foreigner, yet I depend on these selfsame people to collect my taxes and man my army. This simply will not do. I think it is time to bring some boys from back home over to help out here.	The [Root.Culture.GetName] populace in [Root.GetName] have embraced [Root.Holder.Culture.GetName] culture.
EVTDESC55010	My roots may be [Root.Culture.GetName], but I identify more with the [Root.Capital.Culture.GetName] people I rule.	The [Root.Culture.GetName] populace in [Root.GetName] resent me as a ruler and feel that I am a foreigner, yet I depend on these selfsame people to collect my taxes and man my army. This simply will not do. I think it is time to bring some boys from back home over to help out here.
EVTOPTA55010	[Root.Capital.Culture.GetName] customs are superior!	My roots may be [Root.Culture.GetName], but I identify more with the [Root.Capital.Culture.GetName] people I rule.
EVTOPTB55010	Never, I am still [Root.Culture.GetName]!	[Root.Capital.Culture.GetName] customs are superior!
EVTDESC55011	[From.GetTitledName] has adopted the foreign ways of [From.Capital.GetName], behaving more like a petty [From.Capital.Culture.GetName] burgher than a proper [Root.Culture.GetName] lord.	Never, I am still [Root.Culture.GetName]!
EVTOPTA55011	Troubling news	[From.GetTitledName] has adopted the foreign ways of [From.Capital.GetName], behaving more like a petty [From.Capital.Culture.GetName] burgher than a proper [Root.Culture.GetName] lord.
PROV420	Vilnius	Troubling news
PROV423	Trakai	Vilnius
PROV424	Grodno	Trakai
PROV496	Constantinople	Grodno
PROV632	Tus	Constantinople
PROV696	Samarra	Tus
PROV702	Khliat	Samarra
PROV727	Bostra	Khliat
PROV729	Al-Sukhnah	Bostra
PROV929	Aprutium	Al-Sukhnah
c_tadmor_adj	Al-Sukhnahn	Aprutium
c_syria_adj	Bostrian	Al-Sukhnahn
c_mesopotamia_adj	Khliatian	Bostrian
c_euphrates_adj	Samarrian	Khliatian
c_tus_adj	Tusian	Samarrian
c_aukshayts_adj	Vilnian	Tusian
c_sudovia_adj	Trakian	Vilnian
c_jacwiez_adj	Grodnian	Trakian
c_byzantion_adj	Constantinopian	Grodnian
d_hashshashin	Fedayeen	Constantinopian
GRANDHEADMASTER	Grand Headmaster	Hashshashin
GRANDHEADMASTER_FOA	Your Excellency	Grand Headmaster
DEATH_MURDER_HASHSHASHIN	died at the hands of the Hashshashin	Your Excellency
EXPECTED_TO_HAVE_MORE_WIVES	Fewer than §Y$NUM$§W wives: §R$PRESTIGE$§W	died at the hands of the Hashshashin
EXPECTED_TO_HAVE_FEWER_WIVES	More than §Y$NUM$§W wives: §G+$PRESTIGE$§W	Fewer than §Y$NUM$§W wives: §R$PRESTIGE$§W
#tp_wall_q_1_muslim	Mosque Moat	More than §Y$NUM$§W wives: §G+$PRESTIGE$§W
#tp_wall_q_2_muslim	Mosque Gatehouse	Mosque Moat
#tp_wall_q_3_muslim	Mosque Portcullis	Mosque Gatehouse
#tp_wall_q_4_muslim	Deep Mosque Moat	Mosque Portcullis
#tp_wall_q_5_muslim	Mosque Barbicans	Deep Mosque Moat
#tp_wall_1_muslim	Mosque Palisade	Mosque Barbicans
#tp_wall_2_muslim	Small Mosque Wall	Mosque Palisade
#tp_wall_3_muslim	Medium Mosque Wall	Small Mosque Wall
#tp_wall_4_muslim	Large Mosque Wall	Medium Mosque Wall
#tp_wall_5_muslim	Huge Mosque Wall	Large Mosque Wall
#tp_monastery_1_muslim	Musalla	Huge Mosque Wall
#tp_monastery_2_muslim	Small Mosque	Musalla
tp_monastery_1_muslim	Mosque	Small Mosque
tp_monastery_2_muslim	Mosque	Mosque
tp_monastery_3_muslim	Mosque	Mosque
#tp_monastery_4_muslim	Large Mosque	Mosque
tp_monastery_4_muslim	Great Mosque	Large Mosque
tp_monastery_5_muslim	Great Mosque	Great Mosque
tp_monastery_6_muslim	Great Mosque	Great Mosque
#tp_monastery_6_muslim	Grand Mosque	Great Mosque
#tp_barracks_1_muslim	Mosque Militia Quarters	Grand Mosque
#tp_barracks_2_muslim	Small Mosque Militia Grounds	Mosque Militia Quarters
#tp_barracks_3_muslim	Medium Mosque Militia Grounds	Small Mosque Militia Grounds
#tp_barracks_4_muslim	Large Mosque Militia Grounds	Medium Mosque Militia Grounds
#tp_barracks_5_muslim	Great Mosque Militia Grounds	Large Mosque Militia Grounds
#tp_barracks_6_muslim	Huge Mosque Militia Grounds	Great Mosque Militia Grounds
#tp_elite_barracks_1_muslim	Mosque Guard Quarters	Huge Mosque Militia Grounds
#tp_elite_barracks_2_muslim	Small Mosque Barracks	Mosque Guard Quarters
#tp_elite_barracks_3_muslim	Medium Mosque Barracks	Small Mosque Barracks
#tp_elite_barracks_4_muslim	Large Mosque Barracks	Medium Mosque Barracks
#tp_elite_barracks_5_muslim	Great Mosque Barracks	Large Mosque Barracks
#tp_elite_barracks_6_muslim	Huge Mosque Barracks	Great Mosque Barracks
#tp_town_1_muslim	Mosque Village	Huge Mosque Barracks
tp_town_1_muslim	Mosque Town	Mosque Village
tp_town_2_muslim	Mosque Town	Mosque Town
tp_town_3_muslim	Mosque Town	Mosque Town
tp_town_4_muslim	Mosque Town	Mosque Town
tp_town_5_muslim	Mosque Town	Mosque Town
tp_town_6_muslim	Mosque Town	Mosque Town
#tp_town_3_muslim	Large Mosque Town	Mosque Town
#tp_town_4_muslim	Mosque City	Large Mosque Town
#tp_town_5_muslim	Large Mosque City	Mosque City
tp_school_1_muslim	Madrasah Islamic School	Large Mosque City
tp_school_2_muslim	Madrasah Islamic School	Madrasah Islamic School
#tp_school_2_muslim	Large Madrasah Islamic School	Madrasah Islamic School
#ca_keep_1_muslim	Castle Ribat	Large Madrasah Islamic School
#ca_keep_2_muslim	Castle Qasbah	Castle Ribat
#ca_keep_3_muslim	Expanded Qasbah	Castle Qasbah
#ca_keep_4_muslim	Large Qasbah	Expanded Qasbah
#ca_keep_5_muslim	Great Qasbah	Large Qasbah
#ca_keep_6_muslim	Epic Qasbah	Great Qasbah
#ct_marketplace_1_muslim	Town Bazaar	Epic Qasbah
#ct_marketplace_2_muslim	City Bazaar	Town Bazaar
ct_marketplace_3_muslim	Souq Market District	City Bazaar
ct_marketplace_4_muslim	Medina Quarter	Souq Market District
ct_marketplace_5_muslim	Medina Quarter	Medina Quarter
ct_marketplace_6_muslim	Grand Bazaar	Medina Quarter
ct_university_1_muslim	Maktab School	Grand Bazaar
ct_university_2_muslim	Madrasah University	Maktab School
ct_university_3_muslim	Madrasah University	Madrasah University
#ct_university_3_muslim	Large Madrasah University	Madrasah University
opinion_good_work	Good work!	Large Madrasah University
opinion_committed_zina	Committed Zina (sexual intercourse with other man/woman than spouse)	Good work!
ignored_muslim_sins	Averted my eyes from the sins of others	Committed Zina (sexual intercourse with other man/woman than spouse)
opinion_court_calligrapher	Court Calligrapher	Averted my eyes from the sins of others
opinion_disappointed_calligrapher	Disappointed in Court Calligrapher	Court Calligrapher
opinion_grateful_calligrapher	Grateful for the Court Calligrapher's good work	Disappointed in Court Calligrapher
mod_satisfied_work_calligrapher	Satisfactory Calligraphy Work	Grateful for the Court Calligrapher's good work
mod_bad_work_calligrapher	Bad Calligraphy Work	Satisfactory Calligraphy Work
FURUSIYYATITLE	Furusiyya	Bad Calligraphy Work
furusiyya_invite	Let all who profess martial ability be invited	Furusiyya
FAM_FORMER_HUSBANDS	Former Husbands	Let all who profess martial ability be invited
FAM_SECONDARY_WIVES	Secondary Wives	Former Husbands
FAM_FORMER_WIVES	Former Wives	Secondary Wives
CHURCH_NAME	The $RELIGION$ Faith	Former Wives
diligent_poet	Diligent Poet	The $RELIGION$ Faith
diligent_musician	Diligent Musician	Diligent Poet
diligent_architect	Diligent Chief Architect	Diligent Musician
RAMADANTITLE	Ramadan	Diligent Chief Architect
observed_ramadan	Observed Ramadan	Ramadan
plot_kill_character_desc	§Y[From.GetTitledFirstName]§! has decided it is time for §Y[This.GetTitledFirstName]§! to depart this world. §Y[From.GetTitledFirstName]§! and [From.GetPossPronoun] backers will look for opportunities to kill §Y[This.GetTitledFirstName]§! - the higher the Plot Power, the more likely they are to find openings.	Observed Ramadan
EVTDESC8150	Seeing [Root.PlotTarget.GetTitledName] with [Root.PlotTarget.GetPossPronoun] nose deep in the cup, it suddenly struck me that all I need to get rid of [Root.PlotTarget.GetObjectPronoun] is a fine poison...	[From.GetTitledFirstName] has decided it is time for [This.GetTitledFirstName] to depart this world. [From.GetTitledFirstName] and [From.GetPossPronoun] backers will look for opportunities to kill [This.GetTitledFirstName] - the higher the Plot Power, the more likely they are to find openings.
EVTOPTA8150	My co-conspirators will provide...	Seeing [Root.PlotTarget.GetTitledName] with [Root.PlotTarget.GetPossPronoun] nose deep in the cup, it suddenly struck me that all I need to get rid of [Root.PlotTarget.GetObjectPronoun] is a fine poison...
EVTOPTB8150	Buy a rare poison	My co-conspirators will provide...
EVTOPTC8150	Hemlock goes well with the Red...	Buy a rare poison
EVTOPTD8150	Too expensive - I will bide my time	Hemlock goes well with the Red...
EVTTOOLTIP8155	Poison [This.GetTitledName] at the feast next month	Too expensive - I will bide my time
EVTDESC8151	Suddenly, it hit me - poison! Surely the safest way to get rid of troublesome... pests.	Poison [This.GetTitledName] at the feast next month
EVTOPTB8151	Ask the Plot head for funds	Suddenly, it hit me - poison! Surely the safest way to get rid of troublesome... pests.
EVTTOOLTIP8160	Tell [This.GetTitledName] of the idea to kill [This.PlotTarget.GetTitledName]	Ask the Plot head for funds
EVTTOOLTIP8152	Ask [This.GetTitledName] for funds to kill [This.PlotTarget.GetTitledName]	Tell [This.GetTitledName] of the idea to kill [This.PlotTarget.GetTitledName]
EVTDESC8152	My co-conspirator, [From.GetTitledName], is asking for funds to poison [Root.PlotTarget.GetTitledName] at an upcoming banquet...	Ask [This.GetTitledName] for funds to kill [This.PlotTarget.GetTitledName]
EVTOPTA8152	Very well - too bad I will not see it!	My co-conspirator, [From.GetTitledName], is asking for funds to poison [Root.PlotTarget.GetTitledName] at an upcoming banquet...
EVTOPTB8152	Even [Root.PlotTarget.GetHerHis] death is not worth it.	Very well - too bad I will not see it!
EVTTOOLTIP8153	[This.GetTitledName] receives the funds	Even [Root.PlotTarget.GetHerHis] death is not worth it.
EVTTOOLTIP8154	Inform [This.GetTitledName] that I will not pay	[This.GetTitledName] receives the funds
EVTDESC8153	[From.GetTitledName] has sent me the necessary funds to poison [From.PlotTarget.GetTitledName]...	Inform [This.GetTitledName] that I will not pay
EVTDESC8154	[From.GetTitledName] has refused to fund the rare poison needed to off [From.PlotTarget.GetTitledName].	[From.GetTitledName] has sent me the necessary funds to poison [From.PlotTarget.GetTitledName]...
EVTOPTA8154	I will pay for it myself!	[From.GetTitledName] has refused to fund the rare poison needed to off [From.PlotTarget.GetTitledName].
EVTOPTB8154	Forget it	I will pay for it myself!
EVTDESC8155	What a merry feast, surrounded by my friends and loved ones... I feel a thirst coming on. Page, more wine!	Forget it
EVTOPTA8155	Aaah, that's the stuff!	What a merry feast, surrounded by my friends and loved ones... I feel a thirst coming on. Page, more wine!
EVTOPTB8155	Wait, this doesn't smell right!	Aaah, that's the stuff!
EVTDESC8156	Poison! My body is growing numb, but as my sight fades, I die loudly cursing my killer's name!	Wait, this doesn't smell right!
EVTOPTA8156	A million deaths for [FromFrom.GetTitledFirstName]!	Poison! My body is growing numb, but as my sight fades, I die loudly cursing my killer's name!
EVTDESC8157	Poison! My body is growing numb. Someone, please help me! [Root.Religion.GetRandomGodNameCap]...	A million deaths for [FromFrom.GetTitledFirstName]!
EVTOPTA8157	Who would hate me so?	Poison! My body is growing numb. Someone, please help me! [Root.Religion.GetRandomGodNameCap]...
EVTDESC8158	Poisoned wine? How cliché. These amateurs will be brought to justice!	Who would hate me so?
EVTOPTA8158	[FromFrom.GetTitledFirstName] is surely guilty!	Poisoned wine? How cliché. These amateurs will be brought to justice!
EVTDESC8159	I could feel Death breathing down my neck... Who would want me dead?	[FromFrom.GetTitledFirstName] is surely guilty!
EVTOPTA8159	I fear I shall never know	I could feel Death breathing down my neck... Who would want me dead?
EVTDESC8160	My co-conspirator, [From.GetTitledName], has let me know that [Root.PlotTarget.GetTitledName] will die by poisoned wine at an upcoming banquet...	I fear I shall never know
EVTOPTA8160	Classic!	My co-conspirator, [From.GetTitledName], has let me know that [Root.PlotTarget.GetTitledName] will die by poisoned wine at an upcoming banquet...
EVTTOOLTIP8161	Approve the plan	Classic!
EVTDESC8161	[From.GetTitledName] approves of my idea to poison [From.PlotTarget.GetTitledName]. May [Root.Religion.GetRandomGodName] forgive me!	Approve the plan
EVTOPTA8161	Make the preparations	[From.GetTitledName] approves of my idea to poison [From.PlotTarget.GetTitledName]. May [Root.Religion.GetRandomGodName] forgive me!
EVTDESC8162	[From.GetTitledName] has let me know that the plot to kill [From.PlotTarget.GetTitledName] is proceeding well. [From.PlotTarget.GetSubjectPronounCap] will die by poisoned wine at a feast in one month.	Make the preparations
EVTOPTA8162	Classic!	[From.GetTitledName] has let me know that the plot to kill [From.PlotTarget.GetTitledName] is proceeding well. [From.PlotTarget.GetSubjectPronounCap] will die by poisoned wine at a feast in one month.
EVTDESC8163	Success! [From.GetTitledName] died of the poisoned wine. Unfortunately, my complicity was discovered.	Classic!
EVTOPTA8163	Good. But... bad.	Success! [From.GetTitledName] died of the poisoned wine. Unfortunately, my complicity was discovered.
EVTDESC8164	Success! It seems the wine did not agree with [From.GetTitledName]. [From.GetSubjectPronounCap] died not knowing the name of [From.GetPossPronoun] killer.	Good. But... bad.
EVTOPTA8164	I think I will celebrate with... beer.	Success! It seems the wine did not agree with [From.GetTitledName]. [From.GetSubjectPronounCap] died not knowing the name of [From.GetPossPronoun] killer.
EVTDESC8165	Failure! [From.GetTitledName] did not drink the wine and my complicity was discovered.	I think I will celebrate with... beer.
EVTOPTA8165	This is bad...	Failure! [From.GetTitledName] did not drink the wine and my complicity was discovered.
EVTDESC8166	Failure! [From.GetTitledName] did not drink the wine, but was unable to uncover the conspiracy.	This is bad...
EVTOPTA8166	We will just have to try again	Failure! [From.GetTitledName] did not drink the wine, but was unable to uncover the conspiracy.
EVTDESC8170	Seeing the cook's son fall from a tree, I had a flash of inspiration. Children are such foolish and clumsy creatures - how tragic if [Root.PlotTarget.GetTitledName] were to fall off the parapets...	We will just have to try again
EVTOPTA8170	My co-conspirators will know someone...	Seeing the cook's son fall from a tree, I had a flash of inspiration. Children are such foolish and clumsy creatures - how tragic if [Root.PlotTarget.GetTitledName] were to fall off the parapets...
EVTOPTB8170	Bribe a guard	My co-conspirators will know someone...
EVTOPTC8170	I know the perfect man for the job!	Bribe a guard
EVTTOOLTIP8175	[This.GetTitledName] will try [This.GetPossPronoun] wings next month	I know the perfect man for the job!
EVTDESC8171	Ah, children, how they hurt themselves. How rare to see one without a bruise, a bump or a scab. Hmm, what if someone were to take a rather long fall?	[This.GetTitledName] will try [This.GetPossPronoun] wings next month
EVTOPTB8171	Ask the Plot head for funds	Ah, children, how they hurt themselves. How rare to see one without a bruise, a bump or a scab. Hmm, what if someone were to take a rather long fall?
EVTDESC8172	My co-conspirator, [From.GetTitledName], is asking for funds to arrange a tragic falling accident for [Root.PlotTarget.GetTitledName]. Certain retainers need to be bribed...	Ask the Plot head for funds
EVTOPTA8172	Expensive, but worthwhile!	My co-conspirator, [From.GetTitledName], is asking for funds to arrange a tragic falling accident for [Root.PlotTarget.GetTitledName]. Certain retainers need to be bribed...
EVTDESC8173	[From.GetTitledName] has sent me enough money to bribe someone to give [From.PlotTarget.GetTitledName] a gentle push off the parapets.	Expensive, but worthwhile!
EVTDESC8174	[From.GetTitledName] has refused to give me the necessary bribes to have [From.PlotTarget.GetTitledName] fall off the parapets.	[From.GetTitledName] has sent me enough money to bribe someone to give [From.PlotTarget.GetTitledName] a gentle push off the parapets.
EVTDESC8175	I love the thrill of heights, running on the castle walls and looking down at the little people below. If I reach out, maybe I can reach that bird's nest...	[From.GetTitledName] has refused to give me the necessary bribes to have [From.PlotTarget.GetTitledName] fall off the parapets.
EVTOPTA8175	Almost there...	I love the thrill of heights, running on the castle walls and looking down at the little people below. If I reach out, maybe I can reach that bird's nest...
EVTOPTB8175	Wait, who's that behind me?!	Almost there...
EVTDESC8176	AAAH, someone pushed me! I'm falling! NOOO!	Wait, who's that behind me?!
EVTOPTA8176	Death to [FromFrom.GetTitledFirstName]!	AAAH, someone pushed me! I'm falling! NOOO!
EVTOPTA8177	Why? Who? [Root.Religion.GetRandomGodNameCap]...	Death to [FromFrom.GetTitledFirstName]!
EVTDESC8178	He was going to push me! I will find out who bribed him and why!	Why? Who? [Root.Religion.GetRandomGodNameCap]...
EVTOPTA8178	[FromFrom.GetTitledFirstName] must be behind this!	He was going to push me! I will find out who bribed him and why!
EVTDESC8179	Was that scullery maid going to push me off the wall? Who would want me dead?	[FromFrom.GetTitledFirstName] must be behind this!
EVTOPTA8179	I guess I'll never know...	Was that scullery maid going to push me off the wall? Who would want me dead?
EVTDESC8180	Good news! My co-conspirator, [From.GetTitledName], has let me know that [Root.PlotTarget.GetTitledName] will soon have a tragic fall off the castle parapets...	I guess I'll never know...
EVTOPTA8180	Fly, little bird, fly!	Good news! My co-conspirator, [From.GetTitledName], has let me know that [Root.PlotTarget.GetTitledName] will soon have a tragic fall off the castle parapets...
EVTDESC8181	[From.GetTitledName] approves of my scheme to push [From.PlotTarget.GetTitledName] of a wall. May [Root.Religion.GetRandomGodName] forgive me!	Fly, little bird, fly!
EVTDESC8182	[From.GetTitledName] has let me know that the plot to kill [From.PlotTarget.GetTitledName] is proceeding well. [From.PlotTarget.GetSubjectPronounCap] will soon fall off the castle walls. Such tragedy!	[From.GetTitledName] approves of my scheme to push [From.PlotTarget.GetTitledName] of a wall. May [Root.Religion.GetRandomGodName] forgive me!
EVTDESC8183	Success! [From.GetTitledName] flew off those walls like an ostrich! Unfortunately, the assassin was caught and my complicity was discovered.	[From.GetTitledName] has let me know that the plot to kill [From.PlotTarget.GetTitledName] is proceeding well. [From.PlotTarget.GetSubjectPronounCap] will soon fall off the castle walls. Such tragedy!
EVTDESC8184	Success! It seems little [From.GetTitledName] had not yet learned how to fly. [From.GetSubjectPronounCap] died a quick and presumably painless death.	Success! [From.GetTitledName] flew off those walls like an ostrich! Unfortunately, the assassin was caught and my complicity was discovered.
EVTOPTA8184	Chicken for lunch today, I think	Success! It seems little [From.GetTitledName] had not yet learned how to fly. [From.GetSubjectPronounCap] died a quick and presumably painless death.
EVTDESC8185	Failure! [From.GetTitledName] dodged the assassin and ran off. My complicity was discovered.	Chicken for lunch today, I think
EVTOPTA8185	Curses!	Failure! [From.GetTitledName] dodged the assassin and ran off. My complicity was discovered.
EVTDESC8186	Failure! The hired assassin did not get a chance to push [From.GetTitledName] off the walls, and will likely not get another. At least the plot remains unknown...	Curses!
opinion_beautiful_poem	Beautiful Poem	Failure! The hired assassin did not get a chance to push [From.GetTitledName] off the walls, and will likely not get another. At least the plot remains unknown...
opinion_beautiful_song	Beautiful Song	Beautiful Poem
opinion_seduce_spouse	Tried to seduce spouse	Beautiful Song
beautiful_hilya	Beautiful Hilya	Tried to seduce spouse
mod_dissatisfied_calligrapher	Dissatisfying Calligraphic Designs	Beautiful Hilya
mod_perfect_work_calligrapher	Perfect Calligraphic Designs	Dissatisfying Calligraphic Designs
SPECIAL_EVENTOPTION_0	This option is available due to your high §YDiplomacy§! skill	Perfect Calligraphic Designs
SPECIAL_EVENTOPTION_1	This option is available due to your high §YMartial§! skill	This option is available due to your high §YDiplomacy§! skill
SPECIAL_EVENTOPTION_2	This option is available due to your high §YStewardship§! skill	This option is available due to your high §YMartial§! skill
SPECIAL_EVENTOPTION_3	This option is available due to your high §YIntrigue§! skill	This option is available due to your high §YStewardship§! skill
SPECIAL_EVENTOPTION_4	This option is available due to your high §YLearning§! skill	This option is available due to your high §YIntrigue§! skill
SPECIAL_EVENTOPTION_TRAIT	This option is available because you have the §Y$TRAITNAME$§! trait	This option is available due to your high §YLearning§! skill
DECADENCE_TITLE	Dynastic Decadence	This option is available because you have the §Y$TRAITNAME$§! trait
COMBAT_MODIFIER_DESC	§YCombat Modifier§!\nThis modifies any flank led by this character\n\n	Dynastic Decadence
EVTDESC38304	The voices are whispering to me, telling me what to do... horrible, horrible things they want me to do... I have gained the §YLunatic§! trait.	§YCombat Modifier§!\nThis modifies any flank led by this character\n\n
architect_improvements	Chief Architect Improvements	The voices are whispering to me, telling me what to do... horrible, horrible things they want me to do... I have gained the Lunatic trait.
EVTNAME89500	The Travels of Marco Polo	Chief Architect Improvements
EVTDESC89500	The Venetian merchant Marco Polo has finally returned to Europe after many years of travel in the Far East with his father and uncle. An account of their journey has been published as "The Travels of Marco Polo," describing, among other things, the distant lands of Cathay and Manji. Readers are provided a rare glimpse of the world beyond Europe, but there are those who discount the entire chronicle as a fabrication...	The Travels of Marco Polo
EVTOPTA89500	A stunning tale, nonetheless!	The Venetian merchant Marco Polo has finally returned to Europe after many years of travel in the Far East with his father and uncle. An account of their journey has been published as "The Travels of Marco Polo," describing, among other things, the distant lands of Cathay and Manji. Readers are provided a rare glimpse of the world beyond Europe, but there are those who discount the entire chronicle as a fabrication...
EVTNAME89501	The Voyages of Zheng He	A stunning tale, nonetheless!
EVTDESC89501	A great fleet from the distant lands of China has appeared in the Arabian Sea. Commanded by the eunuch explorer Zheng He, or Hajji Mahmud Shamsuddin as he is known in Arabic, the fleet's colossal treasure ships are of a size never before seen in these waters. Despite its formidable strength, the expedition does not seem bent on conquest and will soon depart to explore other lands.	The Voyages of Zheng He
EVTOPTA89501	Safe journey.	A great fleet from the distant lands of China has appeared in the Arabian Sea. Commanded by the eunuch explorer Zheng He, or Hajji Mahmud Shamsuddin as he is known in Arabic, the fleet's colossal treasure ships are of a size never before seen in these waters. Despite its formidable strength, the expedition does not seem bent on conquest and will soon depart to explore other lands.
EVTNAME60116	The Mongols sack Baghdad!	Safe journey.
EVTDESC60116	The great city of Baghdad, one of the world's foremost centers of learning, has succumbed to the ravenous Mongol hordes after a siege. Nothing can sate their appetite for destruction it seems. The Tigris river runs not only red with blood, but black with the ink of priceless and irreplaceable tomes from the House of Wisdom and the city's other great libraries.	The Mongols sack Baghdad!
EVTOPTA60116	Like raging wolves...	The great city of Baghdad, one of the world's foremost centers of learning, has succumbed to the ravenous Mongol hordes after a siege. Nothing can sate their appetite for destruction it seems. The Tigris river runs not only red with blood, but black with the ink of priceless and irreplaceable tomes from the House of Wisdom and the city's other great libraries.
EVTOPTB60116	Let us pray the Mongols are swallowed up by the desert now.	Like raging wolves...
EVTNAME60117	The Mongols sack Damascus!	Let us pray the Mongols are swallowed up by the desert now.
EVTDESC60117	Damascus, the ancient City of Jasmine, has been sacked by the advancing Mongols. They have gathered a colossal pile of severed heads on a field just outside the city walls, now renamed "burj al-ru'us" by the massacre's few survivors - the Tower of Heads.	The Mongols sack Damascus!
EVTOPTA60117	May they suffer a thousand deaths for their crimes!	Damascus, the ancient City of Jasmine, has been sacked by the advancing Mongols. They have gathered a colossal pile of severed heads on a field just outside the city walls, now renamed "burj al-ru'us" by the massacre's few survivors - the Tower of Heads.
EVTOPTB60117	It will fall on those of the True Faith to stop the Tartar scourge.	May they suffer a thousand deaths for their crimes!
EVTNAME60118	The Mongols sack Jerusalem!	It will fall on those of the True Faith to stop the Tartar scourge.
EVTDESC60118	The Tartar infidels have sacked Jerusalem, spurring a moment of rare solidarity between members of all the city's different religions as they suffer equal horrors under the cruel yoke of the pagans.	The Mongols sack Jerusalem!
EVTOPTA60118	Infidels!	The Tartar infidels have sacked Jerusalem, spurring a moment of rare solidarity between members of all the city's different religions as they suffer equal horrors under the cruel yoke of the pagans.
EVTOPTB60118	Heathens!	Infidels!
EVTNAME60119	The Mongols sack Alexandria!	Heathens!
EVTDESC60119	Not content with their vast empire surpassing Alexander the Great's in sheer size, the Mongol hordes are now laying waste to the city that is his namesake as well. Pompey's Pillar has been toppled, but at least the Pharos Lighthouse is spared when the Mongols deem it not worth the great effort it would require to raze it to the ground.	The Mongols sack Alexandria!
EVTOPTA60119	May they suffer an eternity of pain!	Not content with their vast empire surpassing Alexander the Great's in sheer size, the Mongol hordes are now laying waste to the city that is his namesake as well. Pompey's Pillar has been toppled, but at least the Pharos Lighthouse is spared when the Mongols deem it not worth the great effort it would require to raze it to the ground.
EVTOPTB60119	Would that I could follow in Alexander's footsteps...	May they suffer an eternity of pain!
EVTNAME60120	The Mongols sack Cairo!	Would that I could follow in Alexander's footsteps...
EVTDESC60120	Riding through the fertile Nile Delta, the Tartar hordes have arrived at the Great Pyramids of Giza and breached the gates of Cairo. Surely even the cruelest Pharaoh would be given pause by the pain and misery now inflicted on the city's hapless population.	The Mongols sack Cairo!
EVTOPTA60120	Have they no shame?	Riding through the fertile Nile Delta, the Tartar hordes have arrived at the Great Pyramids of Giza and breached the gates of Cairo. Surely even the cruelest Pharaoh would be given pause by the pain and misery now inflicted on the city's hapless population.
EVTOPTB60120	But who is left to tax?	Have they no shame?
EVTNAME60121	The Mongols sack Mecca!	But who is left to tax?
EVTDESC60121	The Holy City of Mecca now burns at the cruel touch of the Mongol infidels. Pilgrims journeying from distant lands to show their submission to Allah are met only with death when approaching the city gates. This unforgivable desecration will be remembered for ages to come.	The Mongols sack Mecca!
EVTOPTA60121	Not a single infidel taking part in this affront will escape justice	The Holy City of Mecca now burns at the cruel touch of the Mongol infidels. Pilgrims journeying from distant lands to show their submission to Allah are met only with death when approaching the city gates. This unforgivable desecration will be remembered for ages to come.
EVTOPTB60121	God forbid this scourge continues west...	Not a single infidel taking part in this affront will escape justice
EVTOPTB60100	They will not come here, Inshallah	God forbid this scourge continues west...
EVTOPTB60101	May the snows of the frozen north claim them	They will not come here, Inshallah
EVTOPTB60102	These horsemen know how to fight!	May the snows of the frozen north claim them
EVTOPTB60103	Their walls were not strong enough...	These horsemen know how to fight!
EVTOPTB60104	Not even the Franks deserve such a fate	Their walls were not strong enough...
EVTOPTB60105	Impressive	Not even the Franks deserve such a fate
EVTOPTB60106	So not even fabled Rome can stand against them	Impressive
EVTOPTB60107	A city floating on water?	So not even fabled Rome can stand against them
EVTOPTB60108	Ar-Rum is no longer a threat...	A city floating on water?
EVTOPTB60109	Their reach seems unlimited...	Ar-Rum is no longer a threat...
EVTOPTB60110	Disconcerting...	Their reach seems unlimited...
EVTOPTB60111	A waste, by the Prophet	Disconcerting...
EVTOPTB60112	Is this what we can expect?	A waste, by the Prophet
EVTOPTB60113	Interesting	Is this what we can expect?
EVTOPTB60114	Unfortunate	Interesting
EVTOPTB60115	Barbaric	Unfortunate
EVTOPTB39010	No, wait. On second thought...	Barbaric
#EVTDESC88000	Word is spreading that a Shiite missionary, Hassan-i Sabbah, has founded a religious order known as the "Hashshashin" somewhere in western Persia. Using trickery and guile, this mysterious cult of trained killers has seized control of the mountain fortress of Alamut and converted it into their headquarters. Already a string of violent murders can be traced back to Hassan's devoted and fearless disciples...	No, wait. On second thought...
EVTNAME88000	Birth of the Assassins	Word is spreading that a Shiite missionary, Hassan-i Sabbah, has founded a religious order known as the "Hashshashin" somewhere in western Persia. Using trickery and guile, this mysterious cult of trained killers has seized control of the mountain fortress of Alamut and converted it into their headquarters. Already a string of violent murders can be traced back to Hassan's devoted and fearless disciples...
EVTOPTA88000	These hashish smokers are harmless...	Birth of the Assassins
EVTDESC88001	The Hashshashin, the elusive Order of Assassins, have expanded their influence into Syria. A branch of their sect has established itself in the mountain fortress of Masyaf, from where they control the surrounding countryside. All across the Holy Land, the Assassins are now hunting those they see as obstacles to their obscure plans...	These hashish smokers are harmless...
EVTNAME88001	The Assassins Spread to Syria	The Hashshashin, the elusive Order of Assassins, have expanded their influence into Syria. A branch of their sect has established itself in the mountain fortress of Masyaf, from where they control the surrounding countryside. All across the Holy Land, the Assassins are now hunting those they see as obstacles to their obscure plans...
EVTOPTA88001	Perhaps these Hashshashin should be taken seriously...	The Assassins Spread to Syria
EVTDESC88002	With the fall of their last fortress, the Hashshashin - the notorious Assassin Order - has been scattered to the winds. The few remaining members of the order have gone into hiding, biding their time in the vain hope that they will one day be able to resume their work.	Perhaps these Hashshashin should be taken seriously...
EVTNAME88002	The Assassins Scatter!	With the fall of their last fortress, the Hashshashin - the notorious Assassin Order - has been scattered to the winds. The few remaining members of the order have gone into hiding, biding their time in the vain hope that they will one day be able to resume their work.
EVTOPTA88002	Their demise was inevitable.	The Assassins Scatter!
EVTDESC88003	The Hashshashin have returned! Somehow, throughout the years, their surviving members have managed to rebuild a measure of their order's former strength. Striking from the shadows, they have retaken one of their old mountain fortresses and now their trained killers are once again hounding those who would act against their interests...	Their demise was inevitable.
EVTNAME88003	The Assassins Resurface!	The Hashshashin have returned! Somehow, throughout the years, their surviving members have managed to rebuild a measure of their order's former strength. Striking from the shadows, they have retaken one of their old mountain fortresses and now their trained killers are once again hounding those who would act against their interests...
EVTOPTA88003	Surely they wouldn't dare strike at me.	The Assassins Resurface!
EVTDESC88004	The Hashshashin are no more. As their fortresses and mountain hideouts burn, the last members of the once feared Assassin Order are hunted like animals and cut down without mercy or compassion when found. Their legacy now survives only in the legends and stories spawned from their exploits.	Surely they wouldn't dare strike at me.
EVTNAME88004	The Assassins are Destroyed!	The Hashshashin are no more. As their fortresses and mountain hideouts burn, the last members of the once feared Assassin Order are hunted like animals and cut down without mercy or compassion when found. Their legacy now survives only in the legends and stories spawned from their exploits.
EVTOPTA88004	Good riddance!	The Assassins are Destroyed!
EVTDESC88007	The word is spreading like wildfire across the lands of the East! Members of the Hashshashin have killed the great warlord [From.GetTitledName]. They stabbed him at his camp in full view of his men, and though the assassins outlived the [From.GetTitle] by only a few seconds, their mission was accomplished. His men swear vengeance against the Assassin Order!	Good riddance!
EVTNAME88007	The [From.GetTitle] is Dead!	The word is spreading like wildfire across the lands of the East! Members of the Hashshashin have killed the great warlord [From.GetTitledName]. They stabbed him at his camp in full view of his men, and though the assassins outlived the [From.GetTitle] by only a few seconds, their mission was accomplished. His men swear vengeance against the Assassin Order!
EVTOPTA88007	By the Prophet!	The [From.GetTitle] is Dead!
EVTDESC88009	Not even the dreaded Hashshashin have been able to give pause to the Mongols in their bid to conquer the world. Several of their members have been killed in a failed attempt on the life of [From.GetTitledName]. He and his men now swear revenge against the hated Order of Assassins.	By the Prophet!
EVTNAME88009	The [From.GetTitle] Foils Assassins!	Not even the dreaded Hashshashin have been able to give pause to the Mongols in their bid to conquer the world. Several of their members have been killed in a failed attempt on the life of [From.GetTitledName]. He and his men now swear revenge against the hated Order of Assassins.
EVTOPTA88009	By the Prophet!	The [From.GetTitle] Foils Assassins!
EVTDESC88010	You wake suddenly in cold sweat with a strong sensation that something is amiss. The flickering candlelight in your tent reveals a plate of hot biscuits and a note pinned by a poisoned dagger next to your bed. It reads: "Mend your decadent ways before it is too late, [Root.GetFirstName]. The Hashshashin are watching."	By the Prophet!
EVTOPTA88010	Perhaps the time for change has come...	You wake suddenly in cold sweat with a strong sensation that something is amiss. The flickering candlelight in your tent reveals a plate of hot biscuits and a note pinned by a poisoned dagger next to your bed. It reads: "Mend your decadent ways before it is too late, [Root.GetFirstName]. The Hashshashin are watching."
EVTDESC88011	Master, terrible news! Your faithful servant, [From.GetTitledName], has been found dead in [From.GetHerHis] home, no doubt at the hands of the vile Hashshashin. Carved by knife into [From.GetHerHis] chest were the words: "[Root.GetFirstName] - You were warned."	Perhaps the time for change has come...
EVTOPTA88011	How dare they?!	Master, terrible news! Your faithful servant, [From.GetTitledName], has been found dead in [From.GetHerHis] home, no doubt at the hands of the vile Hashshashin. Carved by knife into [From.GetHerHis] chest were the words: "[Root.GetFirstName] - You were warned."
EVTDESC88012	As you turn a street corner in [Root.Location.GetName], a strange whistling sound swishes past your ear. Your bodyguards topple over, knives in their throats, and before you can react you are surrounded by robed Hashshashin. Their leader approaches you with a sad look on his face. "May you find what you seek in the life hereafter, friend."	How dare they?!
EVTOPTA88012	But... but I am not ready!	As you turn a street corner in [Root.Location.GetName], a strange whistling sound swishes past your ear. Your bodyguards topple over, knives in their throats, and before you can react you are surrounded by robed Hashshashin. Their leader approaches you with a sad look on his face. "May you find what you seek in the life hereafter, friend."
EVTDESC88016	[From.GetTitledName] staggers past your guards, bleeding profusely from a dozen stab-wounds. As [From.GetSheHe] collapses in a pool of blood at your feet, [From.GetSheHe] gasps with [From.GetHerHis] last breath: "The H-Hashshashin..."	But... but I am not ready!
EVTOPTA88016	Oh my.	[From.GetTitledName] staggers past your guards, bleeding profusely from a dozen stab-wounds. As [From.GetSheHe] collapses in a pool of blood at your feet, [From.GetSheHe] gasps with [From.GetHerHis] last breath: "The H-Hashshashin..."
EVTDESC88017	Your guards bring in a covered basket left just outside your palace. Believing it to be confections from one of your subjects, you hungrily pull away the covering blanket only to reveal the severed, gaping head of [From.GetTitledName]. The mark of the Hashshashin has been carved into the forehead.	Oh my.
EVTOPTA88017	I think I've lost my appetite...	Your guards bring in a covered basket left just outside your palace. Believing it to be confections from one of your subjects, you hungrily pull away the covering blanket only to reveal the severed, gaping head of [From.GetTitledName]. The mark of the Hashshashin has been carved into the forehead.
EVTDESC88018	As you stroll through your palace garden with [From.GetTitledFirstName], you see the brief glint of reflected sunlight on metal as a thrown dagger flashes past and buries itself in your friend's throat. Your bodyguards rush you to safety, but you glimpse a robed assassin scurrying over the palace walls...	I think I've lost my appetite...
EVTOPTA88018	The Hashshashin! Was I the intended target?	As you stroll through your palace garden with [From.GetTitledFirstName], you see the brief glint of reflected sunlight on metal as a thrown dagger flashes past and buries itself in your friend's throat. Your bodyguards rush you to safety, but you glimpse a robed assassin scurrying over the palace walls...
EVTDESC88019	You wake suddenly in cold sweat with a strong sensation that something is amiss. The flickering candlelight in your tent reveals a plate of hot biscuits and a note pinned by a poisoned dagger next to your bed. It reads: "There are a thousand ways to kill a [Root.GetManWoman], [Root.GetFirstName]. The Hashshashin know them all."	The Hashshashin! Was I the intended target?
EVTOPTA88019	Guards! Search the area!	You wake suddenly in cold sweat with a strong sensation that something is amiss. The flickering candlelight in your tent reveals a plate of hot biscuits and a note pinned by a poisoned dagger next to your bed. It reads: "There are a thousand ways to kill a [Root.GetManWoman], [Root.GetFirstName]. The Hashshashin know them all."
EVTDESC7700	[Root.PlotTarget.GetTitledName] is due to tour [Root.PlotTarget.Location.GetName] in an open carriage to receive the accolades and adulation of the common folk. There is bound be an escort, but what if a few archers were placed on the [Root.PlotTarget.GetTitle]'s path on certain key rooftops...	Guards! Search the area!
EVTOPTA7700	My co-conspirators will find some good men...	[Root.PlotTarget.GetTitledName] is due to tour [Root.PlotTarget.Location.GetName] in an open carriage to receive the accolades and adulation of the common folk. There is bound be an escort, but what if a few archers were placed on the [Root.PlotTarget.GetTitle]'s path on certain key rooftops...
EVTOPTB7700	Hire bowmen	My co-conspirators will find some good men...
EVTOPTC7700	I know just the men for this job...	Hire bowmen
#EVTDESC7701	Through my sources I have learned that [Root.PlotTarget.GetTitledName] will be touring [Root.PlotTarget.Location.GetName] in an open carriage. The guards will keep a close watch on the streets, but will they expect bowmen on the rooftops?	I know just the men for this job...
EVTDESC7702	My co-conspirator, [From.GetTitledName], has asked for coin to hire some bowmen to ambush [Root.PlotTarget.GetTitledName] as [Root.PlotTarget.GetSheHe] tours [Root.PlotTarget.Location.GetName] in an open carriage...	Through my sources I have learned that [Root.PlotTarget.GetTitledName] will be touring [Root.PlotTarget.Location.GetName] in an open carriage. The guards will keep a close watch on the streets, but will they expect bowmen on the rooftops?
EVTOPTA7702	Make it happen.	My co-conspirator, [From.GetTitledName], has asked for coin to hire some bowmen to ambush [Root.PlotTarget.GetTitledName] as [Root.PlotTarget.GetSheHe] tours [Root.PlotTarget.Location.GetName] in an open carriage...
EVTDESC7703	[From.GetTitledFirstName] has sent me sufficient coin to hire some skilled archers to greet [From.PlotTarget.GetTitledFirstName] with as [From.PlotTarget.GetSheHe] tours the streets of [Root.PlotTarget.Location.GetName].	Make it happen.
EVTDESC7704	[From.GetTitledFirstName] has refused to grant me the coin necessary to hire skilled bowmen to skewer [From.PlotTarget.GetTitledFirstName].	[From.GetTitledFirstName] has sent me sufficient coin to hire some skilled archers to greet [From.PlotTarget.GetTitledFirstName] with as [From.PlotTarget.GetSheHe] tours the streets of [Root.PlotTarget.Location.GetName].
EVTDESC7705	I decided to tour [Root.Location.GetName] to receive the adulation of my subjects, but as my open carriage took a turn past the scroll depository I suddenly heard the whizzing sound of an arrow flying past mere inches from my head.	[From.GetTitledFirstName] has refused to grant me the coin necessary to hire skilled bowmen to skewer [From.PlotTarget.GetTitledFirstName].
EVTOPTA7705	My God. They're going to kill us all!	I decided to tour [Root.Location.GetName] to receive the adulation of my subjects, but as my open carriage took a turn past the scroll depository I suddenly heard the whizzing sound of an arrow flying past mere inches from my head.
EVTOPTB7705	Did that come from the grassy knoll?	My God. They're going to kill us all!
EVTTOOLTIP7705	Ambush [This.GetTitledFirstName] with an arrow barrage next month.	Did that come from the grassy knoll?
EVTDESC7706	I have been caught in a deadly crossfire! One of the arrows digs into my shoulder, and as I struggle to remove it, the final blow is delivered - an arrow strikes my temple, and my head is thrown back and to the left...	Ambush [This.GetTitledFirstName] with an arrow barrage next month.
EVTOPTA7706	This was no lone bowman. [FromFrom.GetTitledFirstName] orchestrated this!	I have been caught in a deadly crossfire! One of the arrows digs into my shoulder, and as I struggle to remove it, the final blow is delivered - an arrow strikes my temple, and my head is thrown back and to the left...
EVTOPTA7707	Back and to the left...	This was no lone bowman. [FromFrom.GetTitledFirstName] orchestrated this!
EVTDESC7708	My carriage was bombarded with arrows, but thanks to what must surely have been the intervention of [Root.Religion.GetRandomGodName], I miraculously emerged unscathed!	Back and to the left...
EVTOPTA7708	[FromFrom.GetTitledFirstName] has conspired to kill me!	My carriage was bombarded with arrows, but thanks to what must surely have been the intervention of [Root.Religion.GetRandomGodName], I miraculously emerged unscathed!
EVTOPTA7709	Who were those bowmen working for?	[FromFrom.GetTitledFirstName] has conspired to kill me!
EVTDESC7710	I have received word from my co-conspirator, [From.GetTitledFirstName], that the bowmen are in place and waiting for the right moment to strike at [Root.PlotTarget.GetTitledFirstName].	Who were those bowmen working for?
EVTOPTA7710	We are committed then.	I have received word from my co-conspirator, [From.GetTitledFirstName], that the bowmen are in place and waiting for the right moment to strike at [Root.PlotTarget.GetTitledFirstName].
EVTDESC7711	[From.GetTitledFirstName] approves of my plan to ambush [From.PlotTarget.GetTitledFirstName] with archers from the rooftops of [From.PlotTarget.Location.GetName]. May [Root.Religion.GetRandomGodName] forgive me!	We are committed then.
EVTDESC7712	[From.GetTitledFirstName] has let me know that the plot to kill [From.PlotTarget.GetTitledFirstName] is proceeding well. [From.PlotTarget.GetSubjectPronounCap] will soon be skewered by arrows while touring [From.PlotTarget.Location.GetName].	[From.GetTitledFirstName] approves of my plan to ambush [From.PlotTarget.GetTitledFirstName] with archers from the rooftops of [From.PlotTarget.Location.GetName]. May [Root.Religion.GetRandomGodName] forgive me!
EVTDESC7713	Success! [From.GetTitledFirstName] was caught in a deadly arrow crossfire between the scroll depository and a grassy knoll. Unfortunately, the scapegoat we had arranged to take the blame spilled my name.	[From.GetTitledFirstName] has let me know that the plot to kill [From.PlotTarget.GetTitledFirstName] is proceeding well. [From.PlotTarget.GetSubjectPronounCap] will soon be skewered by arrows while touring [From.PlotTarget.Location.GetName].
EVTDESC7714	Success! [From.GetTitledFirstName] was caught in a deadly arrow crossfire between the scroll depository and a grassy knoll. The story we concocted about a "lone bowman" seems to be working perfectly.	Success! [From.GetTitledFirstName] was caught in a deadly arrow crossfire between the scroll depository and a grassy knoll. Unfortunately, the scapegoat we had arranged to take the blame spilled my name.
EVTOPTA7714	One less threat to the establishment.	Success! [From.GetTitledFirstName] was caught in a deadly arrow crossfire between the scroll depository and a grassy knoll. The story we concocted about a "lone bowman" seems to be working perfectly.
EVTDESC7715	Failure! [From.GetTitledFirstName] escaped the arrow barrage unharmed, and one of the captured bowmen revealed my name.	One less threat to the establishment.
EVTOPTA7715	Go to damage control!	Failure! [From.GetTitledFirstName] escaped the arrow barrage unharmed, and one of the captured bowmen revealed my name.
EVTDESC7716	Failure! [From.GetTitledFirstName] escaped the arrow barrage unharmed, but at least all of the hired bowmen made a quiet escape and the conspiracy remains uncovered.	Go to damage control!
EVTDESC7720	Watching the animal pens outside [Root.Location.GetName] gave me an idea in how to deal with [Root.PlotTarget.GetTitledName]. Concentrated manure can be a very explosive substance, and if enough is gathered in a single place and ignited, the blast could prove lethal...	Failure! [From.GetTitledFirstName] escaped the arrow barrage unharmed, but at least all of the hired bowmen made a quiet escape and the conspiracy remains uncovered.
EVTOPTA7720	My co-conspirators will procure the necessary manure...	Watching the animal pens outside [Root.Location.GetName] gave me an idea in how to deal with [Root.PlotTarget.GetTitledName]. Concentrated manure can be a very explosive substance, and if enough is gathered in a single place and ignited, the blast could prove lethal...
EVTOPTB7720	Buy vast amounts of manure	My co-conspirators will procure the necessary manure...
EVTOPTC7720	I know a farmer who has what I need...	Buy vast amounts of manure
EVTDESC7722	My co-conspirator, [From.GetTitledName], has asked for coin to buy copious amounts of explosive manure with which to blow [Root.PlotTarget.GetTitledName] sky high.	I know a farmer who has what I need...
EVTOPTA7722	It might just be crazy enough to work...	My co-conspirator, [From.GetTitledName], has asked for coin to buy copious amounts of explosive manure with which to blow [Root.PlotTarget.GetTitledName] sky high.
EVTDESC7723	[From.GetTitledFirstName] has provided the money I need to procure enough manure to see to the end of [From.PlotTarget.GetTitledFirstName]...	It might just be crazy enough to work...
EVTDESC7724	[From.GetTitledFirstName] has refused to provide enough money to procure the manure needed for an explosion, calling it a "hare-brained scheme."	[From.GetTitledFirstName] has provided the money I need to procure enough manure to see to the end of [From.PlotTarget.GetTitledFirstName]...
EVTDESC7725	Riding through the countryside together with my escort, I come upon a lonely inn. It is empty aside from a nervous-looking innkeeper who nevertheless promises food and wine at a very reasonable price. My party and I sit down at a table.	[From.GetTitledFirstName] has refused to provide enough money to procure the manure needed for an explosion, calling it a "hare-brained scheme."
EVTOPTA7725	Innkeeper! Bring us the best you have to offer!	Riding through the countryside together with my escort, I come upon a lonely inn. It is empty aside from a nervous-looking innkeeper who nevertheless promises food and wine at a very reasonable price. My party and I sit down at a table.
EVTOPTB7725	By [Root.Religion.GetRandomGodName], what is that infernal smell?!	Innkeeper! Bring us the best you have to offer!
EVTTOOLTIP7725	Prepare manure to blow [This.GetTitledFirstName] into the heavens next month.	By [Root.Religion.GetRandomGodName], what is that infernal smell?!
EVTDESC7726	Soon after the innkeeper disappears into the kitchen, we notice a foul odor emanating from somewhere below the floorboards. One of my escort pulls open a loose board to reveal... a massive manure pit. Before we can react further to this bizarre find, the floor explodes beneath my feet...	Prepare manure to blow [This.GetTitledFirstName] into the heavens next month.
EVTOPTA7726	Very clever, [FromFrom.GetTitledFirstName]...	Soon after the innkeeper disappears into the kitchen, we notice a foul odor emanating from somewhere below the floorboards. One of my escort pulls open a loose board to reveal... a massive manure pit. Before we can react further to this bizarre find, the floor explodes beneath my feet...
EVTOPTA7727	KABOOOOOOOM!!!	Very clever, [FromFrom.GetTitledFirstName]...
EVTDESC7728	My guards detain the innkeeper and pull open the floorboards to reveal a massive pit of manure beneath the inn. The innkeeper confesses to having been paid to ignite the manure once we were seated, blowing everyone to kingdom come.	KABOOOOOOOM!!!
EVTOPTA7728	So this was the work of [FromFrom.GetTitledFirstName]...	My guards detain the innkeeper and pull open the floorboards to reveal a massive pit of manure beneath the inn. The innkeeper confesses to having been paid to ignite the manure once we were seated, blowing everyone to kingdom come.
EVTDESC7729	My guards detain the innkeeper and pull open the floorboards to reveal a massive pit of manure beneath the inn. The innkeeper confesses to having been paid to ignite the manure once we were seated, blowing everyone to kingdom come, but his employer concealed his or her identity.	So this was the work of [FromFrom.GetTitledFirstName]...
EVTOPTA7729	Perhaps this wretch was working alone. Off with his head!	My guards detain the innkeeper and pull open the floorboards to reveal a massive pit of manure beneath the inn. The innkeeper confesses to having been paid to ignite the manure once we were seated, blowing everyone to kingdom come, but his employer concealed his or her identity.
EVTDESC7730	[From.GetTitledFirstName], my co-conspirator, has sent word that a massive pit of manure has been prepared under the floorboards of an abandoned inn on a path [Root.PlotTarget.GetTitledFirstName] will travel with [Root.PlotTarget.GetHerHis] escort. Once they are seated at a table...	Perhaps this wretch was working alone. Off with his head!
EVTOPTA7730	...KABOOM!	[From.GetTitledFirstName], my co-conspirator, has sent word that a massive pit of manure has been prepared under the floorboards of an abandoned inn on a path [Root.PlotTarget.GetTitledFirstName] will travel with [Root.PlotTarget.GetHerHis] escort. Once they are seated at a table...
EVTDESC7731	[From.GetTitledFirstName] approves of my plan to blow [From.PlotTarget.GetTitledFirstName] sky high with copious amounts of manure. May [Root.Religion.GetRandomGodName] forgive me!	...KABOOM!
EVTDESC7732	[From.GetTitledFirstName] informs me that [From.PlotTarget.GetTitledFirstName] will soon perish. A pit of manure has been prepared under the floorboards of an abandoned inn where [From.PlotTarget.GetSheHe] will soon be dining. A single spark will send our little problem kingdom come...	[From.GetTitledFirstName] approves of my plan to blow [From.PlotTarget.GetTitledFirstName] sky high with copious amounts of manure. May [Root.Religion.GetRandomGodName] forgive me!
EVTDESC7733	Success! [From.GetTitledFirstName] perished in the manure explosion! Unfortunately, the farmer who provided the manure revealed my name...	[From.GetTitledFirstName] informs me that [From.PlotTarget.GetTitledFirstName] will soon perish. A pit of manure has been prepared under the floorboards of an abandoned inn where [From.PlotTarget.GetSheHe] will soon be dining. A single spark will send our little problem kingdom come...
EVTDESC7734	Success! [From.GetTitledFirstName] perished in the manure explosion! There is no trace of my complicity to be found amongst the rubble.	Success! [From.GetTitledFirstName] perished in the manure explosion! Unfortunately, the farmer who provided the manure revealed my name...
EVTOPTA7734	[From.GetFirstName] went out with a bang.	Success! [From.GetTitledFirstName] perished in the manure explosion! There is no trace of my complicity to be found amongst the rubble.
EVTDESC7735	Failure! [From.GetTitledFirstName] discovered the manure and avoided the explosion. My complicity was revealed.	[From.GetFirstName] went out with a bang.
EVTOPTA7735	What was I thinking? Manure...	Failure! [From.GetTitledFirstName] discovered the manure and avoided the explosion. My complicity was revealed.
EVTDESC7736	Failure! [From.GetTitledFirstName] discovered the manure and avoided the explosion. Thankfully, my role in this remains unknown...	What was I thinking? Manure...
EVTDESC7740	If that whelp [Root.PlotTarget.GetTitledName] is to die, we will need to buy the loyalty of someone unscrupulous nearby, like a maid or a guard.	Failure! [From.GetTitledFirstName] discovered the manure and avoided the explosion. Thankfully, my role in this remains unknown...
EVTOPTA7740	My co-conspirators will procure the necessary funds...	If that whelp [Root.PlotTarget.GetTitledName] is to die, we will need to buy the loyalty of someone unscrupulous nearby, like a maid or a guard.
EVTOPTB7740	Bribe maid	My co-conspirators will procure the necessary funds...
EVTOPTC7740	I know who we can approach...	Bribe maid
#EVTDESC7741	If that whelp [Root.PlotTarget.GetTitledName] is to die, we will need to buy the loyalty of someone unscrupulous nearby, like a maid or a guard.	I know who we can approach...
EVTDESC7742	My co-conspirator, [From.GetTitledName], has requested funds to buy the loyalty of a serving maid close to [Root.PlotTarget.GetTitledFirstName]. She will see to it that the child ceases to be a problem... ceases to be altogether, in fact.	If that whelp [Root.PlotTarget.GetTitledName] is to die, we will need to buy the loyalty of someone unscrupulous nearby, like a maid or a guard.
EVTOPTA7742	I cannot think of a more worthy cause. Send the money!	My co-conspirator, [From.GetTitledName], has requested funds to buy the loyalty of a serving maid close to [Root.PlotTarget.GetTitledFirstName]. She will see to it that the child ceases to be a problem... ceases to be altogether, in fact.
EVTDESC7743	[From.GetTitledFirstName] has given me the coin I need to bribe one of the serving maids working near [Root.PlotTarget.GetTitledFirstName].	I cannot think of a more worthy cause. Send the money!
EVTDESC7744	[From.GetTitledFirstName] will not give me the coin I need to bribe one of the serving maids working near [Root.PlotTarget.GetTitledFirstName].	[From.GetTitledFirstName] has given me the coin I need to bribe one of the serving maids working near [Root.PlotTarget.GetTitledFirstName].
EVTDESC7745	As you lie in your crib, staring up at the ceiling and contemplating your future exploits, an adult enters the room. You recognize her as one of the maids, but this time there is something very cold and distant in her eyes. She approaches you with a pillow in her hands...	[From.GetTitledFirstName] will not give me the coin I need to bribe one of the serving maids working near [Root.PlotTarget.GetTitledFirstName].
EVTOPTA7745	Gaga...?	As you lie in your crib, staring up at the ceiling and contemplating your future exploits, an adult enters the room. You recognize her as one of the maids, but this time there is something very cold and distant in her eyes. She approaches you with a pillow in her hands...
EVTOPTB7745	*emit ear-shattering wail*	Gaga...?
EVTTOOLTIP7745	Arrange for [This.GetTitledFirstName] to be murdered next month.	*emit ear-shattering wail*
EVTDESC7746	The maid puts the pillow over your face and the world grows dark. With luck perhaps you will be reborn in a gentler era...	Arrange for [This.GetTitledFirstName] to be murdered next month.
EVTOPTA7746	[FromFrom.GetTitledFirstName] had my short life cut shorter!	The maid puts the pillow over your face and the world grows dark. With luck perhaps you will be reborn in a gentler era...
EVTOPTA7747	Who put her up to this?	[FromFrom.GetTitledFirstName] had my short life cut shorter!
EVTDESC7748	As the maid draws near, you take a deep breath and produce a piercing wail that echoes through the nearby hallways. The startled maid drops the pillow and runs away before someone comes to investigate.	Who put her up to this?
EVTOPTA7748	[FromFrom.GetTitledFirstName] put her up to this!	As the maid draws near, you take a deep breath and produce a piercing wail that echoes through the nearby hallways. The startled maid drops the pillow and runs away before someone comes to investigate.
EVTOPTA7749	Why would she harm me?	[FromFrom.GetTitledFirstName] put her up to this!
EVTDESC7750	My co-conspirator, [From.GetTitledFirstName], has managed to get to one of the maids near [Root.PlotTarget.GetTitledFirstName]. For a princely sum, she has agreed to solve our little problem for us.	Why would she harm me?
EVTOPTA7750	Fabulous!	My co-conspirator, [From.GetTitledFirstName], has managed to get to one of the maids near [Root.PlotTarget.GetTitledFirstName]. For a princely sum, she has agreed to solve our little problem for us.
EVTDESC7751	[From.GetTitledFirstName] approves of my efforts to bribe a maid to end the life of young [From.PlotTarget.GetTitledFirstName].	Fabulous!
EVTDESC7752	[From.GetTitledFirstName] tells me that the short life of young [From.PlotTarget.GetTitledFirstName] will soon come to an end. A maid close to the child has been bought, and will be solving our mutual problem.	[From.GetTitledFirstName] approves of my efforts to bribe a maid to end the life of young [From.PlotTarget.GetTitledFirstName].
EVTDESC7753	Success! [From.GetTitledFirstName] was smothered with a pillow by the maid we had bribed! Unfortunately, the maid was caught and revealed my complicity in this matter before she hanged.	[From.GetTitledFirstName] tells me that the short life of young [From.PlotTarget.GetTitledFirstName] will soon come to an end. A maid close to the child has been bought, and will be solving our mutual problem.
EVTDESC7754	Success! [From.GetTitledFirstName] was smothered with a pillow by the maid we had bribed! She wasn't caught, and no one has any reason to place blame on me.	Success! [From.GetTitledFirstName] was smothered with a pillow by the maid we had bribed! Unfortunately, the maid was caught and revealed my complicity in this matter before she hanged.
EVTOPTA7754	This world is too cruel for children.	Success! [From.GetTitledFirstName] was smothered with a pillow by the maid we had bribed! She wasn't caught, and no one has any reason place blame on me.
EVTDESC7755	Failure! [From.GetTitledFirstName] frightened off the maid with [From.GetHerHis] wailing, but she was caught and exposed my involvement.	This world is too cruel for children.
EVTOPTA7755	Oh dear.	Failure! [From.GetTitledFirstName] frightened off the maid with [From.GetHerHis] wailing, but she was caught and exposed my involvement.
EVTDESC7756	Failure! [From.GetTitledFirstName] frightened off the maid with [From.GetHerHis] wailing, but at least she made a clean escape and no one suspects my involvement.	Oh dear.
EVTDESC7760	The fact that [Root.PlotTarget.GetTitledName] is in prison can work to our advantage. If we can get someone on the inside to kill [Root.PlotTarget.GetHerHim] and make it look like a failed escape attempt...	Failure! [From.GetTitledFirstName] frightened off the maid with [From.GetHerHis] wailing, but at least she made a clean escape and no one suspects my involvement.
EVTOPTA7760	My co-conspirators will find the man needed...	The fact that [Root.PlotTarget.GetTitledName] is in prison can work to our advantage. If we can get someone on the inside to kill [Root.PlotTarget.GetHerHim] and make it look like a failed escape attempt...
EVTOPTB7760	Hire professional killer	My co-conspirators will find the man needed...
EVTOPTC7760	I know just the man for this...	Hire professional killer
EVTDESC7762	My co-conspirator, [From.GetTitledName], has requested funds to arrange for [Root.PlotTarget.GetTitledName] to die tragically in a botched escape attempt from the prison [Root.PlotTarget.GetSheHe] is in.	I know just the man for this...
EVTOPTA7762	Yes, prison can be very dangerous to your health.	My co-conspirator, [From.GetTitledName], has requested funds to arrange for [Root.PlotTarget.GetTitledName] to die tragically in a botched escape attempt from the prison [Root.PlotTarget.GetSheHe] is in.
EVTDESC7763	[From.GetTitledFirstName] has given me the funds I sought to place a man on the inside of the prison where [Root.PlotTarget.GetTitledFirstName] is jailed.	Yes, prison can be very dangerous to your health.
EVTDESC7764	[From.GetTitledFirstName] has refused me the money I needed to place a man on the inside of the prison where [Root.PlotTarget.GetTitledFirstName] is jailed.	[From.GetTitledFirstName] has given me the funds I sought to place a man on the inside of the prison where [Root.PlotTarget.GetTitledFirstName] is jailed.
EVTDESC7765	While languishing in my prison cell, a new prisoner approached me with a plan to escape this forsaken hellhole. Concealed amongst the many tattoos on his back is a crude map of the entire dungeon!	[From.GetTitledFirstName] has refused me the money I needed to place a man on the inside of the prison where [Root.PlotTarget.GetTitledFirstName] is jailed.
EVTOPTA7765	We can use this to escape!	While languishing in my prison cell, a new prisoner approached me with a plan to escape this forsaken hellhole. Concealed amongst the many tattoos on his back is a crude map of the entire dungeon!
EVTOPTB7765	Wait a second... that's not a real tattoo!	We can use this to escape!
EVTTOOLTIP7765	Arrange for [This.GetTitledFirstName] to perish in a botched escape attempt next month.	Wait a second... that's not a real tattoo!
EVTDESC7766	Using the map, we enter a hidden passageway behind the cells. Working our way to the dungeon's outer walls, we climb carefully on the parapet to avoid sentries. Suddenly, the cold hand of treachery makes itself felt as my "friend" pulls hard on my ankle and I lose my grip...	Arrange for [This.GetTitledFirstName] to perish in a botched escape attempt next month.
EVTOPTA7766	You... you're working for [FromFrom.GetTitledFirstName]!	Using the map, we enter a hidden passageway behind the cells. Working our way to the dungeon's outer walls, we climb carefully on the parapet to avoid sentries. Suddenly, the cold hand of treachery makes itself felt as my "friend" pulls hard on my ankle and I lose my grip...
EVTOPTA7767	Who sent you to kill me?!	You... you're working for [FromFrom.GetTitledFirstName]!
EVTDESC7768	The map is not a tattoo - it been carefully painted onto the prisoner's back. When confronted, he grudgingly admits that he was paid to help me escape while making certain I suffer a fatal accident in the attempt...	Who sent you to kill me?!
EVTOPTA7768	So [FromFrom.GetTitledFirstName] put you up to this.	The map is not a tattoo - it been carefully painted onto the prisoner's back. When confronted, he grudgingly admits that he was paid to help me escape while making certain I suffer a fatal accident in the attempt...
EVTDESC7769	The map is not a tattoo - it been carefully painted onto the prisoner's back. When confronted, he grudgingly admits that he was paid to help me escape while making certain I suffer a fatal accident in the attempt. He claims he never saw the face or learned the name of the person who hired him.	So [FromFrom.GetTitledFirstName] put you up to this.
EVTOPTA7769	You expect me to believe that?	The map is not a tattoo - it been carefully painted onto the prisoner's back. When confronted, he grudgingly admits that he was paid to help me escape while making certain I suffer a fatal accident in the attempt. He claims he never saw the face or learned the name of the person who hired him.
EVTDESC7770	[From.GetTitledFirstName], my co-conspirator, tells me that a man is now on the inside of the prison where [Root.PlotTarget.GetTitledFirstName] sits. He will arrange an escape attempt in which one of the prisoners will sadly suffer a tragic and very fatal accident...	You expect me to believe that?
EVTOPTA7770	No one will expect foul play on our part.	[From.GetTitledFirstName], my co-conspirator, tells me that a man is now on the inside of the prison where [Root.PlotTarget.GetTitledFirstName] sits. He will arrange an escape attempt in which one of the prisoners will sadly suffer a tragic and very fatal accident...
EVTDESC7771	[From.GetTitledFirstName] approves of my plan to arrange for [From.PlotTarget.GetTitledFirstName] to perish in a botched prison escape attempt.	No one will expect foul play on our part.
EVTDESC7772	I have been told by [From.GetTitledFirstName] that the days of [From.PlotTarget.GetTitledFirstName] are numbered. A man on the inside of the prison where [From.PlotTarget.GetSheHe] is will arrange a prison break that will sadly result in a fatality.	[From.GetTitledFirstName] approves of my plan to arrange for [From.PlotTarget.GetTitledFirstName] to perish in a botched prison escape attempt.
EVTDESC7773	Success! [From.GetTitledFirstName] was killed while attempting to escape from prison! Unfortunately, the man on the inside who made this happen mentioned my name when he was captured...	I have been told by [From.GetTitledFirstName] that the days of [From.PlotTarget.GetTitledFirstName] are numbered. A man on the inside of the prison where [From.PlotTarget.GetSheHe] is will arrange a prison break that will sadly result in a fatality.
EVTDESC7774	Success! [From.GetTitledFirstName] was killed while attempting to escape from prison! No fingers will be pointed my way.	Success! [From.GetTitledFirstName] was killed while attempting to escape from prison! Unfortunately, the man on the inside who made this happen mentioned my name when he was captured...
EVTOPTA7774	Sentence commuted!	Success! [From.GetTitledFirstName] was killed while attempting to escape from prison! No fingers will be pointed my way.
EVTDESC7775	Failure! [From.GetTitledFirstName] refused to take the bait and attempt an escape. My role in this plot was inadvertently revealed by our man on the inside...	Sentence commuted!
EVTOPTA7775	Damnation!	Failure! [From.GetTitledFirstName] refused to take the bait and attempt an escape. My role in this plot was inadvertently revealed by our man on the inside...
EVTDESC7776	Failure! [From.GetTitledFirstName] refused to take the bait and attempt an escape. At least no one suspects my role in this.	Damnation!
EVTDESC7780	[Root.PlotTarget.GetTitledName] may be a drooling, incapable mess, but [Root.PlotTarget.GetSheHe] is still very much alive. Every month servants give [Root.PlotTarget.GetHerHim] a sorely needed bath, during which so many things could go wrong... especially if those servants were in our employ.	Failure! [From.GetTitledFirstName] refused to take the bait and attempt an escape. At least no one suspects my role in this.
EVTOPTA7780	My co-conspirators will talk to the servants...	[Root.PlotTarget.GetTitledName] may be a drooling, incapable mess, but [Root.PlotTarget.GetSheHe] is still very much alive. Every month servants give [Root.PlotTarget.GetHerHim] a sorely needed bath, during which so many things could go wrong... especially if those servants were in our employ.
EVTOPTB7780	Bribe servants	My co-conspirators will talk to the servants...
EVTOPTC7780	Arrange for the servants to be replaced with your own.	Bribe servants
EVTDESC7782	I have received a request from my co-conspirator, [From.GetTitledName], to provide funds necessary to bribe the servants giving [Root.PlotTarget.GetTitledName] [Root.PlotTarget.GetHerHis] monthly bath. If paid, they will arrange for a tragic accident...	Arrange for the servants to be replaced with your own.
EVTOPTA7782	Devious. I like it.	I have received a request from my co-conspirator, [From.GetTitledName], to provide funds necessary to bribe the servants giving [Root.PlotTarget.GetTitledName] [Root.PlotTarget.GetHerHis] monthly bath. If paid, they will arrange for a tragic accident...
EVTDESC7783	[From.GetTitledFirstName] has provided, and now I have the funds needed to bribe the servants giving [Root.PlotTarget.GetTitledFirstName] [Root.PlotTarget.GetHerHis] monthly bath.	Devious. I like it.
EVTDESC7784	[From.GetTitledFirstName] refuses to provide the funds needed to bribe the servants giving [Root.PlotTarget.GetTitledFirstName] [Root.PlotTarget.GetHerHis] monthly bath.	[From.GetTitledFirstName] has provided, and now I have the funds needed to bribe the servants giving [Root.PlotTarget.GetTitledFirstName] [Root.PlotTarget.GetHerHis] monthly bath.
EVTDESC7785	The stench of the drooling, incapable mass that is your body troubles even you, and to the delight of everyone around, the time of your monthly bath has finally arrived. Servants lower you into your bathtub and begin the long, arduous process of scrubbing away your filth...	[From.GetTitledFirstName] refuses to provide the funds needed to bribe the servants giving [Root.PlotTarget.GetTitledFirstName] [Root.PlotTarget.GetHerHis] monthly bath.
EVTOPTA7785	*relieve yourself in the bathtub*	The stench of the drooling, incapable mass that is your body troubles even you, and to the delight of everyone around, the time of your monthly bath has finally arrived. Servants lower you into your bathtub and begin the long, arduous process of scrubbing away your filth...
EVTOPTB7785	W-wait... t-those servants look unfamiliar...	*relieve yourself in the bathtub*
EVTTOOLTIP7785	Arrange for [This.GetTitledFirstName] to be drowned during [This.GetHerHis] monthly bath.	W-wait... t-those servants look unfamiliar...
EVTDESC7786	The servants suddenly push your head under the surface and hold you down. You flail your arms about desperately with what little motor function you still possess, but it is to no avail. As the water rushes into your lungs and your life fades away, you regret lost opportunities, harsh words to loved ones and most importantly: relieving yourself in the bathtub.	Arrange for [This.GetTitledFirstName] to be drowned during [This.GetHerHis] monthly bath.
EVTOPTA7786	[FromFrom.GetTitledName] bribed these servants...	The servants suddenly push your head under the surface and hold you down. You flail your arms about desperately with what little motor function you still possess, but it is to no avail. As the water rushes into your lungs and your life fades away, you regret lost opportunities, harsh words to loved ones and most importantly: relieving yourself in the bathtub.
EVTOPTA7787	Who bribed these servants?	[FromFrom.GetTitledName] bribed these servants...
EVTDESC7788	The servants suddenly try to push your head below the water! You muster what little energy you have and trash about wildly, causing enough of a ruckus to attract the attention of a guard. The servants are detained and reveal under torture who bribed them to end your life.	Who bribed these servants?
EVTOPTA7788	So it was [FromFrom.GetTitledName]!	The servants suddenly try to push your head below the water! You muster what little energy you have and trash about wildly, causing enough of a ruckus to attract the attention of a guard. The servants are detained and reveal under torture who bribed them to end your life.
EVTDESC7789	The servants suddenly try to push your head below the water! You muster what little energy you have and trash about wildly, causing enough of a ruckus to attract the attention of a guard. The servants flee before they can be caught.	So it was [FromFrom.GetTitledName]!
EVTOPTA7789	Who bribed them to kill me?	The servants suddenly try to push your head below the water! You muster what little energy you have and trash about wildly, causing enough of a ruckus to attract the attention of a guard. The servants flee before they can be caught.
EVTDESC7790	The servants who will give [Root.PlotTarget.GetTitledFirstName] [Root.PlotTarget.GetHerHis] monthly bath have been bribed by my co-conspirator, [From.GetTitledFirstName]. They will see to it that this bath is [Root.PlotTarget.GetHerHis] last...	Who bribed them to kill me?
EVTOPTA7790	Commendable initiative!	The servants who will give [Root.PlotTarget.GetTitledFirstName] [Root.PlotTarget.GetHerHis] monthly bath have been bribed by my co-conspirator, [From.GetTitledFirstName]. They will see to it that this bath is [Root.PlotTarget.GetHerHis] last...
EVTDESC7791	[From.GetTitledFirstName] lends his full support behind my initiative to bribe the servants giving [From.PlotTarget.GetTitledFirstName] [From.PlotTarget.GetHerHis] bath.	Commendable initiative!
EVTDESC7792	[From.GetTitledFirstName] sends word that the servants giving the incapable [From.PlotTarget.GetTitledFirstName] [From.PlotTarget.GetHerHis] bath have been bribed and will see to it that it is [From.PlotTarget.GetHerHis] last.	[From.GetTitledFirstName] lends his full support behind my initiative to bribe the servants giving [From.PlotTarget.GetTitledFirstName] [From.PlotTarget.GetHerHis] bath.
EVTDESC7793	Success! [From.GetTitledFirstName] was drowned in [From.GetHerHis] bathtub! Unfortunately, the servants we bribed for the deed revealed my complicity under torture.	[From.GetTitledFirstName] sends word that the servants giving the incapable [From.PlotTarget.GetTitledFirstName] [From.PlotTarget.GetHerHis] bath have been bribed and will see to it that it is [From.PlotTarget.GetHerHis] last.
EVTDESC7794	Success! [From.GetTitledFirstName] was drowned in [From.GetHerHis] bathtub! No one suspects the conspiracy behind this deed.	Success! [From.GetTitledFirstName] was drowned in [From.GetHerHis] bathtub! Unfortunately, the servants we bribed for the deed revealed my complicity under torture.
EVTOPTA7794	Yet another argument against taking baths.	Success! [From.GetTitledFirstName] was drowned in [From.GetHerHis] bathtub! No one suspects the conspiracy behind this deed.
EVTDESC7795	Failure! Even incapable, [From.GetTitledFirstName] managed to ward off the clumsy attempts of the servants to drown [From.GetHerHim]. The servants revealed my name under torture.	Yet another argument against taking baths.
EVTOPTA7795	Well, that's no good.	Failure! Even incapable, [From.GetTitledFirstName] managed to ward off the clumsy attempts of the servants to drown [From.GetHerHim]. The servants revealed my name under torture.
EVTDESC7796	Failure! Even incapable, [From.GetTitledFirstName] managed to ward off the clumsy attempts of the servants to drown [From.GetHerHim]. At least they had the good sense to avoid getting caught.	Well, that's no good.
DEATH_YESTERDAY_FLANK	Yesterday's losses on this Flank	Failure! Even incapable, [From.GetTitledFirstName] managed to ward off the clumsy attempts of the servants to drown [From.GetHerHim]. At least they had the good sense to avoid getting caught.
NO_PRESTIGE_MUSLIM_MARRIAGE	Muslims do not receive or lose prestige for marriages	Yesterday's losses on this Flank
CIW_GOTODIPLO	Go to diplomacy\nRight-click to open Submenu	Muslims do not receive or lose prestige for marriages
CIW_GOTOCHAR	Go to character\nRight-click to open Submenu	Go to diplomacy\nRight-click to open Submenu
OFFER_MARRIGE_INTERACTION_MUSLIM	Propose that §Y[ActorExtra.GetTitledFirstName]§W and §Y[RecipientExtra.GetTitledFirstName]§W get married.	Go to character\nRight-click to open Submenu
EVTDESC7800	Whispers have reached my ears that [Root.PlotTarget.GetTitledName] is due to embark on a little boat trip. I have it on good authority that [Root.PlotTarget.GetSheHe], like many children, has not yet learned to swim. If the boat was to flounder... well, these things happen all the time, don't they?	Propose that §Y[ActorExtra.GetTitledFirstName]§W and §Y[RecipientExtra.GetTitledFirstName]§W get married.
EVTOPTA7800	My co-conspirators will find some good men...	Whispers have reached my ears that [Root.PlotTarget.GetTitledName] is due to embark on a little boat trip. I have it on good authority that [Root.PlotTarget.GetSheHe], like many children, has not yet learned to swim. If the boat was to flounder... well, these things happen all the time, don't they?
EVTOPTB7800	Hire men to sabotage the boat	My co-conspirators will find some good men...
EVTOPTC7800	I know just the men for this job...	Hire men to sabotage the boat
EVTDESC7802	My co-conspirator, [From.GetTitledName], is requesting funds to hire a few carpenters who will sabotage a boat that [Root.PlotTarget.GetTitledName] is soon to take a trip onboard. The child does not know how to swim...	I know just the men for this job...
EVTOPTA7802	Send the money... and I really must learn how to swim some day.	My co-conspirator, [From.GetTitledName], is requesting funds to hire a few carpenters who will sabotage a boat that [Root.PlotTarget.GetTitledName] is soon to take a trip onboard. The child does not know how to swim...
EVTDESC7803	[From.GetTitledFirstName] has sent me the money I asked for to hire carpenters. They will prepare the boat before [From.PlotTarget.GetTitledFirstName] boards it.	Send the money... and I really must learn how to swim some day.
EVTDESC7804	[From.GetTitledFirstName] will not give me the necessary coin to hire carpenters. They were needed to prepare the boat before [From.PlotTarget.GetTitledFirstName] boards it.	[From.GetTitledFirstName] has sent me the money I asked for to hire carpenters. They will prepare the boat before [From.PlotTarget.GetTitledFirstName] boards it.
EVTDESC7805	It is a beautiful day as you make your way down to the local harbor with a handful of servants. You will be going on a short boat trip today, something that has you very excited. The vessel awaits at the dock, ready to take you on.	[From.GetTitledFirstName] will not give me the necessary coin to hire carpenters. They were needed to prepare the boat before [From.PlotTarget.GetTitledFirstName] boards it.
EVTOPTA7805	This is going to be great!	It is a beautiful day as you make your way down to the local harbor with a handful of servants. You will be going on a short boat trip today, something that has you very excited. The vessel awaits at the dock, ready to take you on.
EVTOPTB7805	Is... is that thing seaworthy?	This is going to be great!
EVTTOOLTIP7805	Sabotage the boat [This.GetTitledFirstName] is due to travel on.	Is... is that thing seaworthy?
EVTDESC7806	The little boat sails off and you spend some time alone by the railing, staring down into the deep, murky water. Suddenly there is shouting behind you and the boat flounders, sending you into the cold water! You desperately try to stay afloat, but without knowing how to swim, you soon sink beneath the waves...	Sabotage the boat [This.GetTitledFirstName] is due to travel on.
EVTOPTA7806	The boat was sabotaged by [FromFrom.GetTitledFirstName]!	The little boat sails off and you spend some time alone by the railing, staring down into the deep, murky water. Suddenly there is shouting behind you and the boat flounders, sending you into the cold water! You desperately try to stay afloat, but without knowing how to swim, you soon sink beneath the waves...
EVTOPTA7807	Someone sabotaged the boat...	The boat was sabotaged by [FromFrom.GetTitledFirstName]!
EVTDESC7808	Upon closer inspection at your request, the sailors find that the boat has been tampered with! Had it set sail, it would surely have floundered, taking you with it below the waves.	Someone sabotaged the boat...
EVTOPTA7808	[FromFrom.GetTitledFirstName] had his men sabotage the boat!	Upon closer inspection at your request, the sailors find that the boat has been tampered with! Had it set sail, it would surely have floundered, taking you with it below the waves.
EVTOPTA7809	Who is responsible?	[FromFrom.GetTitledFirstName] had his men sabotage the boat!
EVTDESC7810	My co-conspirator, [From.GetTitledFirstName], has let me know that everything has been prepared for a little boating accident [Root.PlotTarget.GetTitledFirstName] is soon to be the victim of.	Who is responsible?
EVTOPTA7810	Ship ahoy!	My co-conspirator, [From.GetTitledFirstName], has let me know that everything has been prepared for a little boating accident [Root.PlotTarget.GetTitledFirstName] is soon to be the victim of.
EVTDESC7811	[From.GetTitledFirstName] sends [From.GetHerHis] approval for the sabotage of the boat that will carry [From.PlotTarget.GetTitledFirstName] to [From.PlotTarget.GetHerHis] watery grave. May [Root.Religion.GetRandomGodName] forgive me!	Ship ahoy!
EVTDESC7812	[From.GetTitledFirstName] has informed me that the plot to kill [From.PlotTarget.GetTitledFirstName] is moving forward according to plan. A month from now [From.PlotTarget.GetSheHe] will be lost forever in an unfortunate boating accident...	[From.GetTitledFirstName] sends [From.GetHerHis] approval for the sabotage of the boat that will carry [From.PlotTarget.GetTitledFirstName] to [From.PlotTarget.GetHerHis] watery grave. May [Root.Religion.GetRandomGodName] forgive me!
EVTDESC7813	Success! [From.GetTitledFirstName] sank like a stone when the boat [From.GetSheHe] was on suffered an unfortunate "accident"! Sadly, it has become obvious the boat suffered sabotage, and all the evidence leads back to me...	[From.GetTitledFirstName] has informed me that the plot to kill [From.PlotTarget.GetTitledFirstName] is moving forward according to plan. A month from now [From.PlotTarget.GetSheHe] will be lost forever in an unfortunate boating accident...
EVTDESC7814	Success! [From.GetTitledFirstName] sank like a stone when the boat [From.GetSheHe] was on suffered an unfortunate "accident"! All evidence of my complicity went down with the ship!	Success! [From.GetTitledFirstName] sank like a stone when the boat [From.GetSheHe] was on suffered an unfortunate "accident"! Sadly, it has become obvious the boat suffered sabotage, and all the evidence leads back to me...
EVTOPTA7814	Man overboard!	Success! [From.GetTitledFirstName] sank like a stone when the boat [From.GetSheHe] was on suffered an unfortunate "accident"! All evidence of my complicity went down with the ship!
EVTDESC7815	Failure! Somehow [From.GetTitledFirstName] discovered the sabotage and the boat never left port. That meddlesome child has linked the evidence back to me...	Man overboard!
EVTOPTA7815	It would have worked...	Failure! Somehow [From.GetTitledFirstName] discovered the sabotage and the boat never left port. That meddlesome child has linked the evidence back to me...
EVTDESC7816	Failure! Somehow [From.GetTitledFirstName] discovered the sabotage and the boat never left port. At least the foolish child has no reason to suspect my involvement.	It would have worked...
EVTDESC7820	There are snakes out there who can fell a grown man instantly with a single bite. If such a one was to visit [Root.PlotTarget.GetTitledName] in [Root.PlotTarget.GetHerHis] bedchambers at night...	Failure! Somehow [From.GetTitledFirstName] discovered the sabotage and the boat never left port. At least the foolish child has no reason to suspect my involvement.
EVTOPTA7820	My co-conspirators will procure the snake...	There are snakes out there who can fell a grown man instantly with a single bite. If such a one was to visit [Root.PlotTarget.GetTitledName] in [Root.PlotTarget.GetHerHis] bedchambers at night...
EVTOPTB7820	Buy snake	My co-conspirators will procure the snake...
EVTOPTC7820	I know where to get this snake...	Buy snake
EVTDESC7822	My co-conspirator, [From.GetTitledName], has asked for coin to buy a rare and extremely lethal snake. If purchased, it will pay [Root.PlotTarget.GetTitledName] a little nightly visit.	I know where to get this snake...
EVTOPTA7822	Give [From.GetHerHim] the money. That serpent could be the answer to our prayers.	My co-conspirator, [From.GetTitledName], has asked for coin to buy a rare and extremely lethal snake. If purchased, it will pay [Root.PlotTarget.GetTitledName] a little nightly visit.
EVTDESC7823	I have received the money from [From.GetTitledFirstName] to buy the snake. I will soon be introducing it to [From.PlotTarget.GetTitledFirstName]...	Give [From.GetHerHim] the money. That serpent could be the answer to our prayers.
EVTDESC7824	[From.GetTitledFirstName] says [From.GetSheHe] will not be sending the coin I need to procure this rare snake!	I have received the money from [From.GetTitledFirstName] to buy the snake. I will soon be introducing it to [From.PlotTarget.GetTitledFirstName]...
EVTDESC7825	It has been a long day and it is with some relief that you retreat to your bedchamber for the night. Your bed is warm and just as you are about to drift off into sleep, you hear a strange hissing sound...	[From.GetTitledFirstName] says [From.GetSheHe] will not be sending the coin I need to procure this rare snake!
EVTOPTA7825	A carpenter will need to look at this bed tomorrow.	It has been a long day and it is with some relief that you retreat to your bedchamber for the night. Your bed is warm and just as you are about to drift off into sleep, you hear a strange hissing sound...
EVTOPTB7825	A snake!	A carpenter will need to look at this bed tomorrow.
EVTTOOLTIP7825	Unleash a poisonous snake on [This.GetTitledFirstName] next month.	A snake!
EVTDESC7826	Something cold and scaly brushes past your naked leg, and as you sit up, you feel a sharp pain in your upper thigh. Pulling back the covers reveals a vicious, hissing snake! You stumble out of bed, but already your sight grows dimmer as the intense pain spreads throughout your body...	Unleash a poisonous snake on [This.GetTitledFirstName] next month.
EVTOPTA7826	That... that serpent belongs to [FromFrom.GetTitledFirstName]!	Something cold and scaly brushes past your naked leg, and as you sit up, you feel a sharp pain in your upper thigh. Pulling back the covers reveals a vicious, hissing snake! You stumble out of bed, but already your sight grows dimmer as the intense pain spreads throughout your body...
EVTOPTA7827	I hate snakes!	That... that serpent belongs to [FromFrom.GetTitledFirstName]!
EVTDESC7828	You immediately roll out of bed before the vile serpent has a chance to strike. The beast recoils and disappears beneath the covers as you run out to fetch the guard.	I hate snakes!
EVTOPTA7828	That snake belongs to [FromFrom.GetTitledFirstName]...	You immediately roll out of bed before the vile serpent has a chance to strike. The beast recoils and disappears beneath the covers as you run out to fetch the guard.
EVTOPTA7829	Who brought that snake here?!	That snake belongs to [FromFrom.GetTitledFirstName]...
EVTDESC7830	My co-conspirator, [From.GetTitledFirstName], has procured a poisonous viper, and sends word that it will soon dig its fangs into [Root.PlotTarget.GetTitledFirstName].	Who brought that snake here?!
EVTOPTA7830	Just don't point that thing at me.	My co-conspirator, [From.GetTitledFirstName], has procured a poisonous viper, and sends word that it will soon dig its fangs into [Root.PlotTarget.GetTitledFirstName].
EVTDESC7831	[From.GetTitledFirstName] is delighted to learn that [From.PlotTarget.GetTitledFirstName] is soon to be the victim of a savage snake attack. May [Root.Religion.GetRandomGodName] forgive me!	Just don't point that thing at me.
EVTDESC7832	[From.GetTitledName] has let me know that the plot to kill [From.PlotTarget.GetTitledName] is proceeding well. Within a month an extremely poisonous snake will be slipped into [From.PlotTarget.GetHerHis] bedchambers.	[From.GetTitledFirstName] is delighted to learn that [From.PlotTarget.GetTitledFirstName] is soon to be the victim of a savage snake attack. May [Root.Religion.GetRandomGodName] forgive me!
EVTDESC7833	Success! The snake performed its duty with aplomb and pumped [From.GetTitledFirstName] full of its deadly venom. Unfortunately, the serpent was caught and the seller has revealed my complicity.	[From.GetTitledName] has let me know that the plot to kill [From.PlotTarget.GetTitledName] is proceeding well. Within a month an extremely poisonous snake will be slipped into [From.PlotTarget.GetHerHis] bedchambers.
EVTDESC7834	Success! The snake performed its duty with aplomb and pumped [From.GetTitledFirstName] full of its deadly venom. It slipped away into the night, and the guards are now too busy contending with a string of lethal snake attacks to search for those responsible.	Success! The snake performed its duty with aplomb and pumped [From.GetTitledFirstName] full of its deadly venom. Unfortunately, the serpent was caught and the seller has revealed my complicity.
EVTOPTA7834	I could kiss that snake! Well, maybe not...	Success! The snake performed its duty with aplomb and pumped [From.GetTitledFirstName] full of its deadly venom. It slipped away into the night, and the guards are now too busy contending with a string of lethal snake attacks to search for those responsible.
EVTDESC7835	Failure! [From.GetTitledFirstName] managed to evade the snake, and the guards caught the serpent as it tried to slither away. The seller was identified and has revealed my complicity...	I could kiss that snake! Well, maybe not...
EVTOPTA7835	I hate snakes.	Failure! [From.GetTitledFirstName] managed to evade the snake, and the guards caught the serpent as it tried to slither away. The seller was identified and has revealed my complicity...
EVTDESC7836	Failure! [From.GetTitledFirstName] managed to evade the snake which slipped away into the darkness. A massive snake-hunt is now underway, but at least no one suspects my involvement.	I hate snakes.
EVTDESC7840	[Root.PlotTarget.GetTitledName] likes to take in the morning air on [Root.PlotTarget.GetHerHis] balcony. The fall would be a long one indeed if someone was to take a tumble from there... perhaps the railing could be "adjusted" slightly.	Failure! [From.GetTitledFirstName] managed to evade the snake which slipped away into the darkness. A massive snake-hunt is now underway, but at least no one suspects my involvement.
EVTOPTA7840	My co-conspirators will find someone who can get this done...	[Root.PlotTarget.GetTitledName] likes to take in the morning air on [Root.PlotTarget.GetHerHis] balcony. The fall would be a long one indeed if someone was to take a tumble from there... perhaps the railing could be "adjusted" slightly.
EVTOPTB7840	Hire carpenter	My co-conspirators will find someone who can get this done...
EVTOPTC7840	I know someone who can get this done...	Hire carpenter
EVTDESC7842	My co-conspirator, [From.GetTitledName], is asking for funds to hire a specialist who will weaken the railing on a balcony that [Root.PlotTarget.GetTitledName] is known to frequent. The fall will be a long one...	I know someone who can get this done...
EVTOPTA7842	Make it happen!	My co-conspirator, [From.GetTitledName], is asking for funds to hire a specialist who will weaken the railing on a balcony that [Root.PlotTarget.GetTitledName] is known to frequent. The fall will be a long one...
EVTDESC7843	[From.GetTitledFirstName] has sent the funds I needed. I can now hire a specialist to weaken the balcony's railing.	Make it happen!
EVTDESC7844	[From.GetTitledFirstName] refuses to provide the funds needed for hiring a specialist to weaken the balcony's railing.	[From.GetTitledFirstName] has sent the funds I needed. I can now hire a specialist to weaken the balcony's railing.
EVTDESC7845	Every morning, especially when the weather is as splendid as it is today, you like to go out on your balcony, lean against the railing and take in a deep breath of fresh air. The view from up here is spectacular.	[From.GetTitledFirstName] refuses to provide the funds needed for hiring a specialist to weaken the balcony's railing.
EVTOPTA7845	The people below look like ants!	Every morning, especially when the weather is as splendid as it is today, you like to go out on your balcony, lean against the railing and take in a deep breath of fresh air. The view from up here is spectacular.
EVTOPTB7845	That railing doesn't look right...	The people below look like ants!
EVTTOOLTIP7845	Arrange for [This.GetTitledFirstName] to fall from [This.GetHerHis] balcony.	That railing doesn't look right...
EVTDESC7846	As you lean forward on the railing, you suddenly hear the sound of splintering wood as it gives way completely and you tumble over the edge. While plummeting towards the ground, you spend your last moments reflecting on the gravity of the situation.	Arrange for [This.GetTitledFirstName] to fall from [This.GetHerHis] balcony.
EVTOPTA7846	[FromFrom.GetTitledFirstName] had someone sabotage that railing!	As you lean forward on the railing, you suddenly hear the sound of splintering wood as it gives way completely and you tumble over the edge. While plummeting towards the ground, you spend your last moments reflecting on the gravity of the situation.
EVTOPTA7847	I will haunt the carpenter who built that railing...	[FromFrom.GetTitledFirstName] had someone sabotage that railing!
EVTDESC7848	You inspect the railing only to discover that someone has sawed through its supports! The slightest nudge would have been enough to make the whole thing topple over the side. Had you leaned against it as usual...	I will haunt the carpenter who built that railing...
EVTOPTA7848	[FromFrom.GetTitledFirstName] had someone sabotage that railing!	You inspect the railing only to discover that someone has sawed through its supports! The slightest nudge would have been enough to make the whole thing topple over the side. Had you leaned against it as usual...
EVTOPTA7849	Who would have done such a thing... and why?	[FromFrom.GetTitledFirstName] had someone sabotage that railing!
EVTDESC7850	My co-conspirator, [From.GetTitledFirstName], has hired someone to saw through the supports of the railing on a balcony [Root.PlotTarget.GetTitledFirstName] is known to frequent. Someone may soon take a bit of a tumble...	Who would have done such a thing... and why?
EVTOPTA7850	Look out below!	My co-conspirator, [From.GetTitledFirstName], has hired someone to saw through the supports of the railing on a balcony [Root.PlotTarget.GetTitledFirstName] is known to frequent. Someone may soon take a bit of a tumble...
EVTDESC7851	[From.GetTitledName] approves of my idea to send [From.PlotTarget.GetTitledFirstName] flying off a balcony. May [Root.Religion.GetRandomGodName] forgive me!	Look out below!
EVTDESC7852	[From.GetTitledName] has let me know that the plot to kill [From.PlotTarget.GetTitledName] is proceeding well. The supports of the railing on a balcony [Root.PlotTarget.GetTitledFirstName] is known to frequent have been critically weakened.	[From.GetTitledName] approves of my idea to send [From.PlotTarget.GetTitledFirstName] flying off a balcony. May [Root.Religion.GetRandomGodName] forgive me!
EVTDESC7853	Success! [From.GetTitledFirstName] fell to the ground like a piece of rotten fruit when the balcony railing gave way. Unfortunately, the carpenter who weakened it had second thoughts and revealed my involvement.	[From.GetTitledName] has let me know that the plot to kill [From.PlotTarget.GetTitledName] is proceeding well. The supports of the railing on a balcony [Root.PlotTarget.GetTitledFirstName] is known to frequent have been critically weakened.
EVTDESC7854	Success! [From.GetTitledFirstName] fell to the ground like a piece of rotten fruit when the balcony railing gave way. A tragic accident, as far as anyone is concerned.	Success! [From.GetTitledFirstName] fell to the ground like a piece of rotten fruit when the balcony railing gave way. Unfortunately, the carpenter who weakened it had second thoughts and revealed my involvement.
EVTOPTA7854	Gravity can be a cruel mistress.	Success! [From.GetTitledFirstName] fell to the ground like a piece of rotten fruit when the balcony railing gave way. A tragic accident, as far as anyone is concerned.
EVTDESC7855	Failure! [From.GetTitledFirstName] discovered the sabotage that had been done on the railing. The carpenter we used was detained and revealed my involvement under torture...	Gravity can be a cruel mistress.
EVTOPTA7855	I can't be blamed for building code violations...	Failure! [From.GetTitledFirstName] discovered the sabotage that had been done on the railing. The carpenter we used was detained and revealed my involvement under torture...
EVTDESC7856	Failure! [From.GetTitledFirstName] discovered the sabotage that had been done on the railing. At least [From.GetSheHe] is clueless as to who deserves the blame for this.	I can't be blamed for building code violations...
EVTDESC7860	Young [Root.PlotTarget.GetTitledName] will soon be going on a hunting trip to learn about the majesty of the wilds. With hounds and other dangerous beasts running around, not to mention arrows flying in every direction, so many things could go wrong during a hunt...	Failure! [From.GetTitledFirstName] discovered the sabotage that had been done on the railing. At least [From.GetSheHe] is clueless as to who deserves the blame for this.
EVTOPTA7860	My co-conspirators will bribe a hunter...	Young [Root.PlotTarget.GetTitledName] will soon be going on hunting trip to learn about the majesty of the wilds. With hounds and other dangerous beasts running around, not to mention arrows flying in every direction, so many things could go wrong during a hunt...
EVTOPTB7860	Bribe hunter	My co-conspirators will bribe a hunter...
EVTOPTC7860	I have some leverage on one of the hunters...	Bribe hunter
EVTDESC7862	My co-conspirator, [From.GetTitledName], has requested funds to bribe one of the hunters taking young [Root.PlotTarget.GetTitledName] on a hunting trip. An accident will be arranged...	I have some leverage on one of the hunters...
EVTOPTA7862	Very good. Send the money.	My co-conspirator, [From.GetTitledName], has requested funds to bribe one of the hunters taking young [Root.PlotTarget.GetTitledName] on a hunting trip. An accident will be arranged...
EVTDESC7863	[From.GetTitledFirstName] has given me the gold I needed to bribe one of the hunters going out with [Root.PlotTarget.GetTitledName].	Very good. Send the money.
EVTDESC7864	For some reason [From.GetTitledFirstName] refuses to provide the gold needed to bribe one of the hunters going out with [Root.PlotTarget.GetTitledFirstName].	[From.GetTitledFirstName] has given me the gold I needed to bribe one of the hunters going out with [Root.PlotTarget.GetTitledName].
EVTDESC7865	You are very excited to be going on your first hunting trip! A skilled hunter will be taking you under his wing and teaching you how to hunt and survive in the wilds. The next couple of days will be one big adventure!	For some reason [From.GetTitledFirstName] refuses to provide the gold needed to bribe one of the hunters going out with [Root.PlotTarget.GetTitledFirstName].
EVTOPTA7865	I can't wait!	You are very excited to be going on your first hunting trip! A skilled hunter will be taking you under his wing and teaching you how to hunt and survive in the wilds. The next couple of days will be one big adventure!
EVTOPTB7865	Why is that hunter so nervous?	I can't wait!
EVTTOOLTIP7865	Arrange for [This.GetTitledFirstName] to perish in a hunting accident.	Why is that hunter so nervous?
EVTDESC7866	The hunter tracks a rabbit and gives you the first shot. As quietly as possible, you draw your bow, take aim and send an arrow into the small animal's flank. Filled with pride you turn around, only to see the hunter aiming his own bow at you, fully drawn. "I am sorry," he whispers before sending the arrow into your throat.	Arrange for [This.GetTitledFirstName] to perish in a hunting accident.
EVTOPTA7866	Gghh... [FromFrom.GetTitledFirstName] got to you...	The hunter tracks a rabbit and gives you the first shot. As quietly as possible, you draw your bow, take aim and send an arrow into the small animal's flank. Filled with pride you turn around, only to see the hunter aiming his own bow at you, fully drawn. "I am sorry," he whispers before sending the arrow into your throat.
EVTOPTA7867	W-why?	Gghh... [FromFrom.GetTitledFirstName] got to you...
EVTDESC7868	As the hunter's behavior becomes increasingly nervous and erratic you decide to confront him about it. Weeping he admits to having been paid a handsome sum to kill you during the hunt and make it look like an accident.	W-why?
EVTOPTA7868	So you were paid by [FromFrom.GetTitledFirstName]...	As the hunter's behavior becomes increasingly nervous and erratic you decide to confront him about it. Weeping he admits to having been paid a handsome sum to kill you during the hunt and make it look like an accident.
EVTOPTA7869	And you say you never saw the face of your employer?	So you were paid by [FromFrom.GetTitledFirstName]...
EVTDESC7870	My co-conspirator, [From.GetTitledFirstName], has bribed a hunter taking [Root.PlotTarget.GetTitledFirstName] on a trip into the wilds to quietly dispatch the child and make it look like an accident. 	And you say you never saw the face of your employer?
EVTOPTA7870	They call it the wilds for a reason.	My co-conspirator, [From.GetTitledFirstName], has bribed a hunter taking [Root.PlotTarget.GetTitledFirstName] on a trip into the wilds to quietly dispatch the child and make it look like an accident. 
EVTDESC7871	[From.GetTitledFirstName] is pleased to learn that [From.PlotTarget.GetTitledFirstName] will soon meet [From.GetHerHis] end in the wilds. May [Root.Religion.GetRandomGodName] forgive me!	They call it the wilds for a reason.
EVTDESC7872	[From.GetTitledName] has let me know that the plot to kill [From.PlotTarget.GetTitledName] is proceeding well. A hunter taking the [From.PlotTarget.GetLadLass] on a trip to the wilds has been generously bribed to cause a tragic hunting accident.	[From.GetTitledFirstName] is pleased to learn that [From.PlotTarget.GetTitledFirstName] will soon meet [From.GetHerHis] end in the wilds. May [Root.Religion.GetRandomGodName] forgive me!
EVTDESC7873	Success! The hunter did what he was paid for and made sure [From.GetTitledFirstName] never returned from the hunting trip. Unfortunately, he later lost his nerve and told everyone willing to listen about my involvement as he drank away his sorrows.	[From.GetTitledName] has let me know that the plot to kill [From.PlotTarget.GetTitledName] is proceeding well. A hunter taking the [From.PlotTarget.GetLadLass] on a trip to the wilds has been generously bribed to cause a tragic hunting accident.
EVTDESC7874	Success! The hunter did what he was paid for and made sure [From.GetTitledFirstName] never returned from the hunting trip. He will keep quiet about his ghastly deed to save his own skin if nothing else.	Success! The hunter did what he was paid for and made sure [From.GetTitledFirstName] never returned from the hunting trip. Unfortunately, he later lost his nerve and told everyone willing to listen about my involvement as he drank away his sorrows.
EVTOPTA7874	To hunt a man is truly the greatest sport...	Success! The hunter did what he was paid for and made sure [From.GetTitledFirstName] never returned from the hunting trip. He will keep quiet about his ghastly deed to save his own skin if nothing else.
EVTDESC7875	Failure! That fool hunter lost his nerve and refused to kill [From.GetTitledFirstName]! What is more, he told the [From.PlotTarget.GetLadLass] everything about the conspiracy - including my involvement!	To hunt a man is truly the greatest sport...
EVTOPTA7875	I knew we couldn't trust him!	Failure! That fool hunter lost his nerve and refused to kill [From.GetTitledFirstName]! What is more, he told the [From.PlotTarget.GetLadLass] everything about the conspiracy - including my involvement!
EVTDESC7876	Failure! That fool hunter lost his nerve and refused to kill [From.GetTitledFirstName]! At least he has decided to keep quiet about the conspiracy to hide the shame of his own involvement.	I knew we couldn't trust him!
EVTDESC7880	[Root.PlotTarget.GetTitledName] will soon travel by carriage on an isolated road. Perhaps if we gathered some mercenaries and disguised them as highwaymen... crime is on the rise, after all.	Failure! That fool hunter lost his nerve and refused to kill [From.GetTitledFirstName]! At least he has decided to keep quiet about the conspiracy to hide the shame of his own involvement.
EVTOPTA7880	My co-conspirators will hire the mercenaries...	[Root.PlotTarget.GetTitledName] will soon travel by carriage on an isolated road. Perhaps if we gathered some mercenaries and disguised them as highwaymen... crime is on the rise, after all.
EVTOPTB7880	Hire mercenaries	My co-conspirators will hire the mercenaries...
EVTOPTC7880	I know the men for this job...	Hire mercenaries
EVTDESC7882	My co-conspirator, [From.GetTitledName], has asked for gold to hire some mercenaries. They will ambush [Root.PlotTarget.GetTitledName] disguised as highwaymen.	I know the men for this job...
EVTOPTA7882	Excellent idea! The gold is yours.	My co-conspirator, [From.GetTitledName], has asked for gold to hire some mercenaries. They will ambush [Root.PlotTarget.GetTitledName] disguised as highwaymen.
EVTDESC7883	[From.GetTitledFirstName] has granted me the gold I asked for to hire mercenaries.	Excellent idea! The gold is yours.
EVTDESC7884	[From.GetTitledFirstName] will not be providing the gold I need to hire the mercenaries.	[From.GetTitledFirstName] has granted me the gold I asked for to hire mercenaries.
EVTDESC7885	You are travelling by carriage in the countryside of [Root.Location.GetName] when it comes to a sudden halt. The road has been blocked by a fallen tree, and the coachman explains that you will have to make a slight detour on an isolated smaller path.	[From.GetTitledFirstName] will not be providing the gold I need to hire the mercenaries.
EVTOPTA7885	Very well, but this had better not delay us!	You are travelling by carriage in the countryside of [Root.Location.GetName] when it comes to a sudden halt. The road has been blocked by a fallen tree, and the coachman explains that you will have to make a slight detour on an isolated smaller path.
EVTOPTB7885	No, you fool! It's a trap!	Very well, but this had better not delay us!
EVTTOOLTIP7885	Arrange for [This.GetTitledFirstName] to die in a roadside ambush.	No, you fool! It's a trap!
EVTDESC7886	After less than half a league on the small path, you are ambushed and surrounded by highwaymen! They send your driver on his way, explaining that their interest lies with you alone. You offer the belongings you carry with you, but they merely laugh at this - it is your blood they want.	Arrange for [This.GetTitledFirstName] to die in a roadside ambush.
EVTOPTA7886	I see. Disguised mercenaries working for [FromFrom.GetTitledFirstName]...	After less than half a league on the small path, you are ambushed and surrounded by highwaymen! They send your driver on his way, explaining that their interest lies with you alone. You offer the belongings you carry with you, but they merely laugh at this - it is your blood they want.
EVTOPTA7887	Y-you're not highwaymen!	I see. Disguised mercenaries working for [FromFrom.GetTitledFirstName]...
EVTDESC7888	You force your way through the improvised barricade, narrowly avoiding an ambush by highwaymen! They send an accurate volley of arrows after your carriage as it speeds away, missing it by mere inches.	Y-you're not highwaymen!
EVTOPTA7888	Only mercenaries in the employ of [FromFrom.GetTitledFirstName] are so precise...	You force your way through the improvised barricade, narrowly avoiding an ambush by highwaymen! They send an accurate volley of arrows after your carriage as it speeds away, missing it by mere inches.
EVTOPTA7889	Too accurate for highwaymen. Only mercenaries are so precise...	Only mercenaries in the employ of [FromFrom.GetTitledFirstName] are so precise...
EVTDESC7890	My co-conspirator, [From.GetTitledFirstName], has assembled a party of mercenaries who will ambush [Root.PlotTarget.GetTitledFirstName] disguised as highwaymen. I am assured [Root.PlotTarget.GetSheHe] will not survive the encounter.	Too accurate for highwaymen. Only mercenaries are so precise...
EVTOPTA7890	Yes, the roads just aren't safe anymore...	My co-conspirator, [From.GetTitledFirstName], has assembled a party of mercenaries who will ambush [Root.PlotTarget.GetTitledFirstName] disguised as highwaymen. I am assured [Root.PlotTarget.GetSheHe] will not survive the encounter.
EVTDESC7891	[From.GetTitledFirstName] has communicated [From.GetHerHis] support for my plan to ambush [From.PlotTarget.GetTitledFirstName] with mercenaries disguised as highwaymen. May [Root.Religion.GetRandomGodName] forgive me!	Yes, the roads just aren't safe anymore...
EVTDESC7892	[From.GetTitledName] has let me know that the plot to kill [From.PlotTarget.GetTitledName] is proceeding well. A party of mercenaries in [From.GetHerHis] employ will ambush [From.PlotTarget.GetFirstName] disguised as mercenaries within a month.	[From.GetTitledFirstName] has communicated [From.GetHerHis] support for my plan to ambush [From.PlotTarget.GetTitledFirstName] with mercenaries disguised as highwaymen. May [Root.Religion.GetRandomGodName] forgive me!
EVTDESC7893	Success! The mercenaries ambushed the carriage of [From.GetTitledFirstName] and made short work of [From.GetHerHim]. Unfortunately, the driver survived and saw through their disguises. My involvement is now public knowledge...	[From.GetTitledName] has let me know that the plot to kill [From.PlotTarget.GetTitledName] is proceeding well. A party of mercenaries in [From.GetHerHis] employ will ambush [From.PlotTarget.GetFirstName] disguised as mercenaries within a month.
EVTDESC7894	Success! The mercenaries ambushed the carriage of [From.GetTitledFirstName] and made short work of [From.GetHerHim]. They let the driver go, and he is convinced the attack was carried out by highwaymen.	Success! The mercenaries ambushed the carriage of [From.GetTitledFirstName] and made short work of [From.GetHerHim]. Unfortunately, the driver survived and saw through their disguises. My involvement is now public knowledge...
EVTOPTA7894	Oh, those nasty bandits!	Success! The mercenaries ambushed the carriage of [From.GetTitledFirstName] and made short work of [From.GetHerHim]. They let the driver go, and he is convinced the attack was carried out by highwaymen.
EVTDESC7895	Failure! [From.GetTitledFirstName] got away from the ambush, and [From.GetSheHe] saw through the disguises of the mercenaries, identifying them as men in my employ!	Oh, those nasty bandits!
EVTOPTA7895	The plan looked good on paper...	Failure! [From.GetTitledFirstName] got away from the ambush, and [From.GetSheHe] saw through the disguises of the mercenaries, identifying them as men in my employ!
EVTDESC7896	Failure! [From.GetTitledFirstName] got away from the ambush, but at least the disguises of the mercenaries held up, concealing my involvement.	The plan looked good on paper...
EVTDESC7900	[Root.PlotTarget.GetTitledName] will soon embark on a lengthy journey by carriage, during which so many things could go wrong. If we could buy the loyalty of the carriage driver...	Failure! [From.GetTitledFirstName] got away from the ambush, but at least the disguises of the mercenaries held up, concealing my involvement.
EVTOPTA7900	My co-conspirators will bribe the driver...	[Root.PlotTarget.GetTitledName] will soon embark on a lengthy journey by carriage, during which so many things could go wrong. If we could buy the loyalty of the carriage driver...
EVTOPTB7900	Bribe driver	My co-conspirators will bribe the driver...
EVTOPTC7900	I know how to persuade the driver...	Bribe driver
EVTDESC7902	My co-conspirator, [From.GetTitledName], wants money to bribe the driver of the carriage taking [Root.PlotTarget.GetTitledName] on a lengthy journey. An accident will be arranged along the way...	I know how to persuade the driver...
EVTOPTA7902	The money will be sent.	My co-conspirator, [From.GetTitledName], wants money to bribe the driver of the carriage taking [Root.PlotTarget.GetTitledName] on a lengthy journey. An accident will be arranged along the way...
EVTDESC7903	I have received the money from [From.GetTitledFirstName]. It is enough to bribe the driver!	The money will be sent.
EVTDESC7904	[From.GetTitledFirstName] has decided not to send me the money I needed to bribe the carriage driver...	I have received the money from [From.GetTitledFirstName]. It is enough to bribe the driver!
EVTDESC7905	You are going on a lengthy journey by closed carriage in [Root.Location.GetName] together with some of your trusted bodyguards. As you travel down a steep slope overlooking a ravine, you notice that you have begun to pick up quite a bit of speed.	[From.GetTitledFirstName] has decided not to send me the money I needed to bribe the carriage driver...
EVTOPTA7905	Excellent, we shall make good time.	You are going on a lengthy journey by closed carriage in [Root.Location.GetName] together with some of your trusted bodyguards. As you travel down a steep slope overlooking a ravine, you notice that you have begun to pick up quite a bit of speed.
EVTOPTB7905	Everybody out!	Excellent, we shall make good time.
EVTTOOLTIP7905	Arrange for [This.GetTitledFirstName] perish in a carriage accident.	Everybody out!
EVTDESC7906	The speed of the carriage picks up even more as it hurtles down the slope. Looking through the rear window you see a waving man holding the reins of two familiar-looking horses far behind on the road. Only when the carriage flies over the edge of the ravine do you realize who it was the man reminded you of - your driver...	Arrange for [This.GetTitledFirstName] perish in a carriage accident.
EVTOPTA7906	[FromFrom.GetTitledFirstName] must have bribed him!	The speed of the carriage picks up even more as it hurtles down the slope. Looking through the rear window you see a waving man holding the reins of two familiar-looking horses far behind on the road. Only when the carriage flies over the edge of the ravine do you realize who it was the man reminded you of - your driver...
EVTOPTA7907	That rat!	[FromFrom.GetTitledFirstName] must have bribed him!
EVTDESC7908	You and your guards throw yourself out of the carriage before it flies over the edge of the ravine. Far behind is your fleeing driver with the horses, but your guards catch up with and detain the man. He admits to having been paid generously to see you suffer a fatal accident during the journey.	That rat!
EVTOPTA7908	Paid by [FromFrom.GetTitledFirstName], you say?	You and your guards throw yourself out of the carriage before it flies over the edge of the ravine. Far behind is your fleeing driver with the horses, but your guards catch up with and detain the man. He admits to having been paid generously to see you suffer a fatal accident during the journey.
EVTOPTA7909	And you don't know by whom? You will hang for this.	Paid by [FromFrom.GetTitledFirstName], you say?
EVTDESC7910	My co-conspirator, [From.GetTitledFirstName], has sent word that the carriage [Root.PlotTarget.GetTitledFirstName] is travelling on will soon suffer an unfortunate accident leaving no survivors.	And you don't know by whom? You will hang for this.
EVTOPTA7910	Those things are deathtraps...	My co-conspirator, [From.GetTitledFirstName], has sent word that the carriage [Root.PlotTarget.GetTitledFirstName] is travelling on will soon suffer an unfortunate accident leaving no survivors.
EVTDESC7911	[From.GetTitledFirstName] approves of my scheme to have [From.PlotTarget.GetTitledFirstName] perish in an unfortunate carriage accident. May [Root.Religion.GetRandomGodName] forgive me!	Those things are deathtraps...
EVTDESC7912	[From.GetTitledName] has let me know that the plot to kill [From.PlotTarget.GetTitledName] is proceeding well. A tragic carriage accident will claim [From.PlotTarget.GetHerHis] life a month from now...	[From.GetTitledFirstName] approves of my scheme to have [From.PlotTarget.GetTitledFirstName] perish in an unfortunate carriage accident. May [Root.Religion.GetRandomGodName] forgive me!
EVTDESC7913	Success! The carriage was sent flying over the edge of a cliff with [From.GetTitledFirstName] still in it. Unfortunately, the driver I bribed was caught and my involvement was revealed during his torture...	[From.GetTitledName] has let me know that the plot to kill [From.PlotTarget.GetTitledName] is proceeding well. A tragic carriage accident will claim [From.PlotTarget.GetHerHis] life a month from now...
EVTDESC7914	Success! The carriage was sent flying over the edge of a cliff with [From.GetTitledFirstName] still in it. The driver I bribed has also been dealt with, leaving no loose ends that can tie me to this event.	Success! The carriage was sent flying over the edge of a cliff with [From.GetTitledFirstName] still in it. Unfortunately, the driver I bribed was caught and my involvement was revealed during his torture...
EVTOPTA7914	Shame on such a nice carriage, though.	Success! The carriage was sent flying over the edge of a cliff with [From.GetTitledFirstName] still in it. The driver I bribed has also been dealt with, leaving no loose ends that can tie me to this event.
EVTDESC7915	Failure! The carriage was sent flying into a ravine, but [From.GetTitledFirstName] jumped out moments earlier. The driver was caught and has revealed my complicity in this plot.	Shame on such a nice carriage, though.
EVTOPTA7915	That spineless little...	Failure! The carriage was sent flying into a ravine, but [From.GetTitledFirstName] jumped out moments earlier. The driver was caught and has revealed my complicity in this plot.
kurdish	Kurdish	That spineless little...
EVTDESC7916	Failure! The carriage was sent flying into a ravine, but [From.GetTitledFirstName] jumped out moments earlier. At least the driver was killed by [From.GetHerHis] guards before my involvement could be exposed.	Kurdish
ENDGAME_TEXT_THEOCRACY	You have become the ruler of a Theocracy and are therefore no longer allowed to continue playing. 	Failure! The carriage was sent flying into a ravine, but [From.GetTitledFirstName] jumped out moments earlier. At least the driver was killed by [From.GetHerHis] guards before my involvement could be exposed.
ENDGAME_TEXT_REPUBLIC	You have become the ruler of a Republic and are therefore no longer allowed to continue playing. 	You have become the ruler of a Theocracy and are therefore no longer allowed to continue playing. 
ENDGAME_TEXT_MUSLIM	You have become a Muslim and are therefore no longer allowed to continue playing. 	You have become the ruler of a Republic and are therefore no longer allowed to continue playing. 
EVTOPTB69060	Expose the courtier as not Christian enough	You have become a Muslim and are therefore no longer allowed to continue playing. 
EVTDESC100110	I want that job, and I want it bad! There's no way [Root.Liege.GetTitledFirstName] will give it to me just because I want to become a councillor, I need to work hard to get it.	Expose the courtier as not Christian enough
EVTTOOLTIP100111	[Root.GetTitledFirstName] plans to become friends with [This.GetTitledFirstName] to eventually gain the [This.GetJobTitle] job...	I want that job, and I want it bad! There's no way [Root.Liege.GetTitledFirstName] will give it to me just because I want to become a councillor, I need to work hard to get it.
EVTDESC100111	It's no big secret [From.GetTitledFirstName] is after my job as [Root.GetJobTitle], but [From.GetSheHe] did surprise me when [From.GetSheHe] asked me outright for help. Should I really teach [From.GetTitledFirstName] the secrets of my trade only to make it easier for [From.GetHerHim] to steal my position as [Root.GetJobTitle] in [Root.Liege.GetTitledFirstName]'s court?	[Root.GetTitledFirstName] plans to become friends with [This.GetTitledFirstName] to eventually gain the [This.GetJobTitle] job...
		It's no big secret [From.GetTitledFirstName] is after my job as [Root.GetJobTitle], but [From.GetSheHe] did surprise me when [From.GetSheHe] asked me outright for help. Should I really teach [From.GetTitledFirstName] the secrets of my trade only to make it easier for [From.GetHerHim] to steal my position as [Root.GetJobTitle] in [Root.Liege.GetTitledFirstName]'s court?
