#CODE	ENGLISH	ENGLISH
NAME_W_NICK	$TITLE$ $NAME$ '$NICK$'	$TITLE$ $NAME$ '$NICK$'
#VASSAL_RETRACTION_SETUP	A Vassal has been retracted	A Vassal has been retracted
VASSAL_RETRACTION_LOG	$TOP_LIEGE$ has retracted the vassalage of $VASSAL$ from $OLD_LIEGE$	$TOP_LIEGE$ has retracted the vassalage of $VASSAL$ from $OLD_LIEGE$
opinion_retracted_my_vassal	Retracted my Vassal	Retracted my Vassal
opinion_retracted_my_de_jure_vassal	Retracted my de jure Vassal	Retracted my de jure Vassal
opinion_retracted_a_vassal	Retracted a Vassal	Retracted a Vassal
opinion_retracted_a_de_jure_vassal	Retracted a de jure Vassal	Retracted a de jure Vassal
RETRACT_VASSAL_INTERACTION_TITLE	Retract Vassalage	Retract Vassalage
RETRACT_VASSAL_INTERACTION_DESC	Retract a vassal from §Y[Recipient.GetBestName]§!.	Retract a vassal from §Y[Recipient.GetBestName]§!.
RETRACT_VASSAL_INTERACTION_LONG_DESC	You can retract a vassal from one of your direct vassals. They will not be happy about this, especially if it is their de jure vassal.	You can retract a vassal from one of your direct vassals. They will not be happy about this, especially if it is their de jure vassal.
RETRACT_VASSAL_INTERACTION_0	Select a vassal to retract from §Y[Recipient.GetTitledFirstName]§W.	Select a vassal to retract from §Y[Recipient.GetTitledFirstName]§W.
RETRACT_VASSAL_INTERACTION_1	Make §Y[ThirdPartyCharacter.GetBestName]§W your direct vassal, decreasing §Y[Recipient.GetTitledFirstName]§W's opinion of you by §R$OPINION$§W.	Make §Y[ThirdPartyCharacter.GetBestName]§W your direct vassal, decreasing §Y[Recipient.GetTitledFirstName]§W's opinion of you by §R$OPINION$§W.
RETRACT_VASSAL_INTERACTION_2	Thanks to the crown authority in the §Y$CROWN_TITLE$§!, our vassals cannot object.	Thanks to the crown authority in the §Y$CROWN_TITLE$§!, our vassals cannot object.
RETRACT_VASSAL_INTERACTION_2B	Since §Y[Recipient.GetTitledFirstName]§! is a traitor, our vassals will not object.	Since §Y[Recipient.GetTitledFirstName]§! is a traitor, our vassals will not object.
RETRACT_VASSAL_INTERACTION_2C	Since §Y[Recipient.GetTitledFirstName]§! is an infidel, only §Y[Recipient.Religion.GetName]§! vassals will object (§R$OPINION$§!).	Since §Y[Recipient.GetTitledFirstName]§! is a filthy §Y[Recipient.Religion.GetName]§!, our vassals will not object.
RETRACT_VASSAL_INTERACTION_2D	This is a breach of the feudal contract and will upset your other vassals (§R$OPINION$§!).	This is a breach of the feudal contract and will upset your other vassals (§R$OPINION$§!).
RETRACT_VASSAL_INTERACTION_2N	This is a breach of the feudal contract and will upset your other non-Nomadic vassals (§R$OPINION$§!).	Our Imperial administration allows us to retract vassals without objections from the aristocracy.
RETRACT_VASSAL_INTERACTION_2E	Our Imperial administration allows us to retract vassals without objections from the aristocracy.	Vassal Retracted
RETRACT_VASSAL_INTERACTION_ACCEPT_SETUP	Vassal Retracted	§Y[Actor.GetBestName]§W has transferred the vassalage of §Y[ThirdPartyCharacter.GetBestName]§W from §Y[Recipient.GetBestName]§W
RETRACT_VASSAL_INTERACTION_ACCEPT_LOG	§Y[Actor.GetBestName]§W has transferred the vassalage of §Y[ThirdPartyCharacter.GetBestName]§W from §Y[Recipient.GetBestName]§W	We have decided to retract the vassalage of [ThirdPartyCharacter.GetBestName]. Failure to accept will lead to war.
RETRACT_VASSAL_INTERACTION_LETTER	We have decided to retract the vassalage of [ThirdPartyCharacter.GetBestName]. Failure to accept will lead to war.	Vassal Retraction Refused
RETRACT_VASSAL_INTERACTION_DECLINE_SETUP	Vassal Retraction Refused	§Y[Recipient.GetBestName]§W refused the retraction of the vassal §Y[ThirdPartyCharacter.GetBestName]§W, demanded by §Y[Actor.GetBestName]§W
RETRACT_VASSAL_INTERACTION_DECLINE_LOG	§Y[Recipient.GetBestName]§W refused the retraction of the vassal §Y[ThirdPartyCharacter.GetBestName]§W, demanded by §Y[Actor.GetBestName]§W	My liege, I accept your decision to retract my vassal, [Root.GetBestName], though it grieves me deeply.
EVTDESC274	My liege, I accept your decision to retract my vassal, [Root.GetBestName], though it grieves me deeply.	Your breach of the feudal contract is unacceptable, I will not give up my vassals without a fight!
EVTDESC275	Your breach of the feudal contract is unacceptable, I will not give up my vassals without a fight!	Cannot destroy titles under Gavelkind succession
CANNOT_DESTROY_GAVELKIND_TITLE	Cannot destroy titles under Gavelkind succession	§Y[Actor.GetBestName]§! can afford to lose §Y$COST$§W [Player.Religion.GetPietyName]
INTERACTION_REQUIRES_PIETY	§Y[Actor.GetTitledFirstName]§! can afford to lose §Y$COST$§W [Player.Religion.GetPietyName]	§Y[Actor.GetBestName]§! can pay §Y$COST$§W¤
INTERACTION_REQUIRES_MONEY	§Y[Actor.GetTitledFirstName]§! can pay §Y$COST$§W¤	§Y[Actor.GetBestName]§! can afford to lose §Y$COST$§W Prestige
INTERACTION_REQUIRES_PRESTIGE	§Y[Actor.GetTitledFirstName]§! can afford to lose §Y$COST$§W Prestige	Celtic Unit Pack
CelticUnitPackDLC	Celtic Unit Pack	Celtic Portraits
CelticPortraitsDLC	Celtic Portraits	Broken Spirit
broken_spirit	Broken Spirit	Subjugated
opinion_subjugated_other_rel	Subjugated	Taran
d_meath_adj_irish	Taran	Ghanan Band
d_ghanan_band	Ghanan Band	Ghanan
d_ghanan_band_adj	Ghanan	Is Claimant
AIREASON_CONSORT_CLAIMANT	Is Claimant	With the ambition to become king of §Y[PrimaryTitle.GetName]§!, §Y[GetTitovledFirstName]§! is not allowed to move the capital outside the de jure kingdom.
#RULER_HAS_BECOME_KING_AMBITION	With the ambition to become king of §Y[PrimaryTitle.GetName]§!, §Y[GetTitovledFirstName]§! is not allowed to move the capital outside the de jure kingdom.	Hellenic
hellenic_pagan	Hellenic	The Hellenistic religion is polytheistic, with a pantheon of twelve major gods including Jupiter, Mars, Mercury, Venus, Minerva and Vesta. It originated in ancient Greece and with the conquests of Alexander the Great and the Roman Empire, it would go on to become the dominant religion in the Mediterranean world until the rise of Christendom. Defining features in-game: \n§Y*§! Can declare Subjugation Wars against all other pagans\n§Y*§! Rulers cannot declare Holy Wars\n§Y*§! Inferior at conversion and vulnerable to non-pagan missionaries
hellenic_pagan_DESC	The Hellenistic religion is polytheistic, with a pantheon of twelve major gods including Jupiter, Mars, Mercury, Venus, Minerva and Vesta. It originated in ancient Greece and with the conquests of Alexander the Great and the Roman Empire, it would go on to become the dominant religion in the Mediterranean world until the rise of Christendom.	Jupiter
GOD_JUPITER	Jupiter	Mercury
GOD_MERCURY	Mercury	Mars
GOD_MARS	Mars	Venus
GOD_VENUS	Venus	Minerva
GOD_MINERVA	Minerva	Vesta
GOD_VESTA	Vesta	Since the dawn of history, both Europe and the Middle East has been home to countless Pagan religions and cults unrelated to the Abrahamic faiths. Defining features in-game:\n§Y*§! Rulers are limited to Gavelkind Succession\n§Y*§! Rulers cannot declare Holy Wars\n§Y*§! Inferior at conversion and vulnerable to non-pagan missionaries
pagan_DESC	Since the dawn of history, both Europe and the Middle East has been home to countless Pagan religions and cults unrelated to the Abrahamic faiths.	The Aztec Church
d_aztec_reformed	The Aztec Church	Diviner
job_spiritual_hellenic_pagan	Diviner	Diviner
job_spiritual_pagan	Diviner	Pagans are allowed to subjugate other pagan rulers once in their lifetime. (With the 'Become King' ambition, there is no such time limit against targets within the kingdom.) Free men are always willing to follow the mightiest ruler...
#pagan_subjugation_desc	Pagans are allowed to subjugate other pagan rulers once in their lifetime. (With the 'Become King' ambition, there is no such time limit against targets within the kingdom.) Free men are always willing to follow the mightiest ruler...	
