#CODE	ENGLISH	ENGLISH
IS_NOT_LOVER_OF	Is NOT a Lover of §Y$WHO$§!	Is NOT a Lover of §Y$WHO$§!
IS_LOVER_OF	Is a Lover of §Y$WHO$§!	Is a Lover of §Y$WHO$§!
HAS_LESS_SPOUSES_THAN	Has fewer spouses than 	Has fewer spouses than 
HAS_MORE_SPOUSES_THAN	Number of spouses at least 	Number of spouses at least 
HAS_LESS_CONSORTS_THAN	Has fewer consorts than 	Has fewer consorts than 
HAS_MORE_CONSORTS_THAN	Number of consorts at least 	Number of consorts at least 
HAS_LESS_LOVERS_THAN	Has fewer lovers than 	Has fewer lovers than 
HAS_MORE_LOVERS_THAN	Number of lovers at least 	Number of lovers at least 
ANY_LOVER_STARTS	Any Lover	Any Lover
AIREASON_AGE_DIFFERENCE	Difference in Age	Difference in Age
ANY_CLAIM_STARTS	Any Claim	Any Claim
IS_PACIFIST	Is a Pacifist 	Is a Pacifist 
IS_NOT_PACIFIST	Is NOT a Pacifist 	Is NOT a Pacifist 
EVTDESC_RoI_10003	My beloved [GetFromRelation] is showing every sign of being my reborn [GetFromReincarnationRelation] [From.Reincarnation.GetFirstName]. Little [From.GetFirstName] often speaks of [From.GetPossPronoun] old friends and family, even naming many correctly.	My beloved [GetFromRelation] is showing every sign of being my reborn [GetFromReincarnationRelation] [From.Reincarnation.GetFirstName]. Little [From.GetFirstName] often speaks of [From.GetPossPronoun] old friends and family, even naming many correctly.
conscript_merchant_ships	Conscript Merchant Ships	Conscript Merchant Ships
conscript_merchant_ships_desc	With holdings overseas, my realm has a quite a bit of merchant shipping that can be conscripted in times of war - for a tidy sum of gold, of course...	With holdings overseas, my realm has a quite a bit of merchant shipping that can be conscripted in times of war - for a tidy sum of gold, of course...
HAS_NO_OVERSEAS_HOLDINGS	Has NO overseas holdings	Has NO overseas holdings
HAS_OVERSEAS_HOLDINGS	Has overseas holdings	Has overseas holdings
OUT_OF_SUPPLIES	This unit has been out of supplies for	This unit has been out of supplies for
MATCHMAKING_SERVER_HOST_TITLE	Host Game Settings	Host Game Settings
SAMRAT_CHAKRAVARTIN	Samrat Chakravartin	Samrat Chakravartin
SAMRAJNI_CHAKRAVARTIN	Samrajni Chakravartin	Samrajni Chakravartin
CHARVIEW_RELATIONS	Relations	Relations
ADD_FRIEND_EFFECT	§Y$WHO$§W and §Y$OTHER$§W become close friends.\n	$WHO$ and §Y$OTHER$§W become close friends.\n
REMOVE_FRIEND_EFFECT	The friendship between §Y$WHO$§W and §Y$OTHER$§W ends.\n	The friendship between $WHO$ and §Y$OTHER$§W ends.\n
ADD_RIVAL_EFFECT	$WHO$ and §Y$OTHER$§W become bitter rivals.\n	$WHO$ and §Y$OTHER$§W become bitter rivals.\n
REMOVE_RIVAL_EFFECT	The rivalry between $WHO$ and §Y$OTHER$§W ends.\n	The rivalry between $WHO$ and §Y$OTHER$§W ends.\n
AIREASON_GLAD_TO_TAKE_HOSTAGE	Glad to Take Hostage	Glad to Take Hostage
convert_to_local_culture	Convert to Local Culture ([Root.Capital.Culture.GetName])	Convert to Local Culture ([Root.Capital.Culture.GetName])
convert_to_local_culture_desc	I catch myself thinking in the [Root.Capital.Culture.GetName] language all the time. I govern the [Root.Capital.Culture.GetName] people of [Root.Capital.GetName], but am I truly one of them?	I catch myself thinking in the [Root.Capital.Culture.GetName] language all the time. I govern the [Root.Capital.Culture.GetName] people of [Root.Capital.GetName], but am I truly one of them?
convert_to_local_religion	Convert to Local Religion ([Root.Capital.Religion.GetName])	Convert to Local Religion ([Root.Capital.Religion.GetName])
convert_to_local_religion_desc	The §Y[Root.Capital.Religion.GetName]§! people in §Y[Root.Capital.GetName]§! impress me with the depth and passion of their faith. I am tempted to convert and embrace the glory of §Y[Root.Capital.Religion.GetRandomGodName]§!...	The §Y[Root.Capital.Religion.GetName]§! people in §Y[Root.Capital.GetName]§! impress me with the depth and passion of their faith. I am tempted to convert and embrace the glory of §Y[Root.Capital.Religion.GetRandomGodName]§!...
e_india	India	India
EVTDESC_RoI_403	Ganges is the embodiment of all sacred waters in Hindu mythology and is personified in the goddess Ganga. As you live fairly close to this great river, your Upadhyaya suggests that you make a visit.	Ganges is the embodiment of all sacred waters in Hindu mythology and is personified in the goddess Ganga. As you live fairly close to this great river, your Upadhyaya suggests that you make a visit.
EVTOPTA_RoI_403	I will go.	I will go.
EVTOPTB_RoI_403	I have no time.	I have no time.
EVTDESC_RoI_404	You have arrived at the banks of the Ganges. You enter a temple at the banks of the river, avoiding the throng of the common pilgrims. The sacred waters offer a ritual of purification and will strengthen your link to the divine.	You have arrived at the banks of the Ganges. You enter a temple at the banks of the river, avoiding the throng of the common pilgrims. The sacred waters offer a ritual of purification and will strengthen your link to the divine.
EVTOPTA_RoI_404	I descend into the water and Ganga washes away my sins.	I descend into the water and Ganga washes away my sins.
EVTDESC_RoI_3150	Your court guru doesnt' talk much. He gives strange advice and has also been caught drinking on several occasions. You're beginning to doubt that he's a real guru.	Your court guru doesnt' talk much. He gives strange advice and has also been caught drinking on several occasions. You're beginning to doubt that he's a real guru.
EVTOPTA_RoI_3150	I must investigate this.	I must investigate this.
EVTOPTB_RoI_3150	Who cares?	Who cares?
EVTDESC_RoI_3151	You've had your court guru watched for several weeks. He secretly drinks and smokes herbs, he keeps sneaking out to pleasure houses in disguise, and spends the money he gets from donations on playing cards.	You've had your court guru watched for several weeks. He secretly drinks and smokes herbs, he keeps sneaking out to pleasure houses in disguise, and spends the money he gets from donations on playing cards.
EVTOPTA_RoI_3151	I must confront him.	I must confront him.
EVTOPTB_RoI_3151	Actually, that's my kind of guru.	Actually, that's my kind of guru.
EVTDESC_RoI_3152	As you confront your court guru over his habits, he breaks down and pleads for mercy: 'I confess, I'm an impostor. Please have mercy on me - I'm just a common man trying to make a living.'	As you confront your court guru over his habits, he breaks down and pleads for mercy: 'I confess, I'm an impostor. Please have mercy on me - I'm just a common man trying to make a living.'
EVTOPTA_RoI_3152	It's the dungeons for you!	It's the dungeons for you!
EVTOPTB_RoI_3152	Leave my palace now. Your charade is over.	Leave my palace now. Your charade is over.
EVTDESC_RoI_3100	Your court guru has come to see you: 'I must speak to you of an important matter, [Root.GetLordLady] [Root.GetFirstName]... We must always seek wisdom and try to walk the righteous path in life. It is not fitting for a noble ruler to be a drunkard.' He bows and looks at you in silence.	You court guru has come to see you: 'I must speak to you of an important matter, [Root.GetLordLady] [Root.GetFirstName]... We must always seek wisdom and try to walk the righteous path in life. It is not fitting for a noble ruler to be a drunkard.' He bows and looks at you in silence.
EVTOPTA_RoI_3100	I shall strive to improve.	I shall strive to improve.
EVTOPTB_RoI_3100	Leave me alone.	Leave me alone.
EVTOPTC_RoI_3100	No one speaks to me like that!	No one speaks to me like that!
EVTDESC_RoI_3101	Your court guru has come to see you: 'I must speak to you of an important matter, [Root.GetLordLady] [Root.GetFirstName]... We must always seek wisdom and try to walk the righteous path in life. It is not fitting for a noble ruler to be such a hedonist.' He bows and looks at you in silence.	You court guru has come to see you: 'I must speak to you of an important matter, [Root.GetLordLady] [Root.GetFirstName]... We must always seek wisdom and try to walk the righteous path in life. It is not fitting for a noble ruler to be such a hedonist.' He bows and looks at you in silence.
EVTDESC_RoI_3102	Your court guru has come to see you: 'I must speak to you of an important matter, [Root.GetLordLady] [Root.GetFirstName]... We must always seek wisdom and try to walk the righteous path in life. It is not fitting for a noble ruler to be known as an impaler.' He bows and looks at you in silence.	You court guru has come to see you: 'I must speak to you of an important matter, [Root.GetLordLady] [Root.GetFirstName]... We must always seek wisdom and try to walk the righteous path in life. It is not fitting for a noble ruler to be known as an impaler.' He bows and looks at you in silence.
EVTDESC_RoI_3103	Your court guru has come to see you: 'I must speak to you of an important matter, [Root.GetLordLady] [Root.GetFirstName]... We must always seek wisdom and try to walk the righteous path in life. It is not fitting for a noble ruler to be so lecherous and lustful.' He bows and looks at you in silence.	You court guru has come to see you: 'I must speak to you of an important matter, [Root.GetLordLady] [Root.GetFirstName]... We must always seek wisdom and try to walk the righteous path in life. It is not fitting for a noble ruler to be so lecherous and lustful.' He bows and looks at you in silence.
EVTDESC_RoI_3104	Your court guru has come to see you: 'I must speak to you of an important matter, [Root.GetLordLady] [Root.GetFirstName]... We must always seek wisdom and try to walk the righteous path in life. It is not fitting for a noble ruler to be gluttonous.' He bows and looks at you in silence.	You court guru has come to see you: 'I must speak to you of an important matter, [Root.GetLordLady] [Root.GetFirstName]... We must always seek wisdom and try to walk the righteous path in life. It is not fitting for a noble ruler to be gluttonous.' He bows and looks at you in silence.
EVTDESC_RoI_3105	Your court guru has come to see you: 'I must speak to you of an important matter, [Root.GetLordLady] [Root.GetFirstName]... We must always seek wisdom and try to walk the righteous path in life. It is not fitting for a noble ruler to be so greedy.' He bows and looks at you in silence.	You court guru has come to see you: 'I must speak to you of an important matter, [Root.GetLordLady] [Root.GetFirstName]... We must always seek wisdom and try to walk the righteous path in life. It is not fitting for a noble ruler to be so greedy.' He bows and looks at you in silence.
EVTDESC_RoI_3106	Your court guru has come to see you: 'I must speak to you of an important matter, [Root.GetLordLady] [Root.GetFirstName]... We must always seek wisdom and try to walk the righteous path in life. It is not fitting for a noble ruler to be consumed by envy.' He bows and looks at you in silence.	You court guru has come to see you: 'I must speak to you of an important matter, [Root.GetLordLady] [Root.GetFirstName]... We must always seek wisdom and try to walk the righteous path in life. It is not fitting for a noble ruler to be consumed by envy.' He bows and looks at you in silence.
EVTDESC_RoI_3107	Your court guru has come to see you: 'I must speak to you of an important matter, [Root.GetLordLady] [Root.GetFirstName]... We must always seek wisdom and try to walk the righteous path in life. It is not fitting for a noble ruler to be so wroth.' He bows and looks at you in silence.	You court guru has come to see you: 'I must speak to you of an important matter, [Root.GetLordLady] [Root.GetFirstName]... We must always seek wisdom and try to walk the righteous path in life. It is not fitting for a noble ruler to be so wroth.' He bows and looks at you in silence.
EVTDESC_RoI_3108	Your court guru has come to see you: 'I must speak to you of an important matter, [Root.GetLordLady] [Root.GetFirstName]... We must always seek wisdom and try to walk the righteous path in life. It is not fitting for a noble ruler to have so much pride.' He bows and looks at you in silence.	You court guru has come to see you: 'I must speak to you of an important matter, [Root.GetLordLady] [Root.GetFirstName]... We must always seek wisdom and try to walk the righteous path in life. It is not fitting for a noble ruler to have so much pride.' He bows and looks at you in silence.
EVTDESC_RoI_3109	Your court guru has come to see you: 'I must speak to you of an important matter, [Root.GetLordLady] [Root.GetFirstName]... We must always seek wisdom and try to walk the righteous path in life. It is not fitting for a noble ruler to be so arbitrary in [Root.GetHerHis] rule.' He bows and looks at you in silence.	You court guru has come to see you: 'I must speak to you of an important matter, [Root.GetLordLady] [Root.GetFirstName]... We must always seek wisdom and try to walk the righteous path in life. It is not fitting for a noble ruler to be so arbitrary in [Root.GetHerHis] rule.' He bows and looks at you in silence.
EVTDESC_RoI_3110	Your court guru has come to see you: 'I must speak to you of an important matter, [Root.GetLordLady] [Root.GetFirstName]... We must always seek wisdom and try to walk the righteous path in life. It is not fitting for a noble ruler to be so cynical.' He bows and looks at you in silence.	You court guru has come to see you: 'I must speak to you of an important matter, [Root.GetLordLady] [Root.GetFirstName]... We must always seek wisdom and try to walk the righteous path in life. It is not fitting for a noble ruler to be so cynical.' He bows and looks at you in silence.
EVTDESC_RoI_3111	Your court guru has come to see you: 'I must speak to you of an important matter, [Root.GetLordLady] [Root.GetFirstName]... We must always seek wisdom and try to walk the righteous path in life. It is not fitting for a noble ruler to be so prone to cruelty.' He bows and looks at you in silence.	You court guru has come to see you: 'I must speak to you of an important matter, [Root.GetLordLady] [Root.GetFirstName]... We must always seek wisdom and try to walk the righteous path in life. It is not fitting for a noble ruler to be so prone to cruelty.' He bows and looks at you in silence.
EVTDESC_RoI_3112	Your court guru has come to see you: 'I must speak to you of an important matter, [Root.GetLordLady] [Root.GetFirstName]... We must always seek wisdom and try to walk the righteous path in life. It is not fitting for a noble ruler to be a duelist and engage in violence for sport.' He bows and looks at you in silence.	You court guru has come to see you: 'I must speak to you of an important matter, [Root.GetLordLady] [Root.GetFirstName]... We must always seek wisdom and try to walk the righteous path in life. It is not fitting for a noble ruler to be a duelist and engage in violence for sport.' He bows and looks at you in silence.
EVTDESC_RoI_3113	Your court guru has come to see you: 'I must speak to you of an important matter, [Root.GetLordLady] [Root.GetFirstName]... We must always seek wisdom and try to walk the righteous path in life. It is not fitting for a noble ruler to hunt innocent animals for sport.' He bows and looks at you in silence.	You court guru has come to see you: 'I must speak to you of an important matter, [Root.GetLordLady] [Root.GetFirstName]... We must always seek wisdom and try to walk the righteous path in life. It is not fitting for a noble ruler to hunt innocent animals for sport.' He bows and looks at you in silence.
EVTDESC_RoI_3114	Your court guru has come to see you: 'I must speak to you of an important matter, [Root.GetLordLady] [Root.GetFirstName]... We must always seek wisdom and try to walk the righteous path in life. It is not fitting for a noble ruler to show so little trust in those around [Root.GetHerHim].' He bows and looks at you in silence.	You court guru has come to see you: 'I must speak to you of an important matter, [Root.GetLordLady] [Root.GetFirstName]... We must always seek wisdom and try to walk the righteous path in life. It is not fitting for a noble ruler to show so little trust in those around [Root.GetHerHim].' He bows and looks at you in silence.
EVTDESC_RoI_410	Priests from a local Hindu temple have approached you, asking for donations. They need to expand the temple with a new building in order to accomodate the growing number of worshipers.	Priests from a local Hindu temple have approached you, asking for donations. They need to expand the temple with a new building in order to accomodate the growing number of worshippers.
EVTOPTA_RoI_410	I will help you. Make sure you put in a large Shiva statue.	I will help you. Make sure you put in a large Shiva statue.
EVTOPTB_RoI_410	I will help you. Make sure you put in a large Vishnu statue.	I will help you. Make sure you put in a large Vishnu statue.
EVTOPTC_RoI_410	I will help you. Make sure you put in a large Brahma statue.	I will help you. Make sure you put in a large Brahma statue.
EVTOPTD_RoI_410	I will help you. Make sure you put in a large Kali statue.	I will help you. Make sure you put in a large Kali statue.
EVTOPTE_RoI_410	I will help you. Make sure you put in a large Ganesha statue.	I will help you. Make sure you put in a large Ganesha statue.
EVTOPTF_RoI_410	I will help you. Make sure you put in a large Ganga statue.	I will help you. Make sure you put in a large Ganga statue.
EVTOPTG_RoI_410	I will help you with a small donation.	I will help you with a small donation.
EVTOPTH_RoI_410	I'm sorry, I don't have the funds.	I'm sorry, I don't have the funds.
EVTDESC_RoI_411	Monks from a local monastery have approached you, asking for donations. They need to accomodate the rising number of worshipers and still have enough provisions to maintain their other work and studies.	Monks from a local monastery have approached you, asking for donations. They need to accomodate the rising number of worshippers and still have enough provisions to maintain their other work and studies.
EVTOPTA_RoI_411	Give them gold.	Give them gold.
EVTOPTB_RoI_411	Give them food.	Give them food.
EVTOPTC_RoI_411	This is none of my concern.	This is none of my concern.
EVTDESC_RoI_412	There have been increasing complaints from merchants in the nearby town lately. It seems a number of naked Jain ascetics have taken to sit and preach in the main square. The merchants say they understand the need to respect other religions, but the naked ascetics are driving away customers and upsetting people's sensitivities.	There have been increasing complaints from merchants in the nearby town lately. It seems a number of naked Jain ascetics have taken to sit and preach in the main square. The merchants say they understand the need to respect other religions, but the naked ascetics are driving away customers and upsetting people's sensitivities.
EVTOPTA_RoI_412	Why do you bother me with this petty nonsense?	Why do you bother me with this petty nonsense?
EVTOPTB_RoI_412	We will ask the ascetics to move to a less prominent location.	We will ask the ascetics to move to a less prominent location.
EVTOPTC_RoI_412	My soldiers will throw these heathens out town!	My soldiers will throw these heathens out town!
merchants_unhappy	The merchants are unhappy	The merchants are unhappy
realm_jains_upset	Jains in your realm are upset.	Jains in your realm are upset.
gambler	Gambler	Gambler
opinion_sacrilege	Sacrilegious Acts	Sacrilegious Acts
sacrilege_tooltip	This sacrilege will be widely known.	This sacrilege will be widely known.
EVTDESC_RoI_163	A priest from the local temple has arrived, asking speak with you: 'My [Root.GetLordLady], the holy elephants at the temple are all sick. However, we have learned that there is a healer in a neighboring province who is famous for healing ailing elephants. He is, however, most expensive...'	A priest from the local temple has arrived, asking speak with you: 'My [Root.GetLordLady], the holy elephants at the temple are all sick. However, we have learned that there is a healer in a neighboring province who is famous for healing ailing elephants. He is, however, most expensive...'
EVTOPTA_RoI_163	How unfortunate for you.	How unfortunate for you.
EVTOPTB_RoI_163	I shall pay for it.	I shall pay for it.
EVTDESC_RoI_164	My [Root.GetLordLady], messengers have arrived from the great [From.GetFullName]. It seems [From.GetSheHe] has decided to honor you with the grandest of all gifts, a white elephant!	My [Root.GetLordLady], messengers have arrived from the great [From.GetFullName]. It seems [From.GetSheHe] has decided to honor you with the grandest of all gifts, a white elephant!
EVTOPTA_RoI_164	I will accept this gracious gift.	I will accept this gracious gift.
EVTOPTB_RoI_164	I will not accept it.	I will not accept it.
EVTDESC_RoI_165	You will need to build a proper stable for your white elephant. It is a unique and holy animal and must have an abode fitting its status.	You will need to build a proper stable for your white elephant. It is a unique and holy animal and must have an abode fitting its status.
EVTOPTA_RoI_165	I shall build it a house of fine woods and gold.	I shall build it a house of fine woods and gold.
EVTOPTB_RoI_165	A normal elephant pen will do.	A normal elephant pen will do.
EVTDESC_RoI_166	My [Root.GetLordLady], the guards keeping watch over your white elephant report that they have caught some trespassers. It seems they are members of a rather strange local Ganesha cult, and they have been stealing the white elephant's dung for worship.	My [Root.GetLordLady], the guards keeping watch over your white elephant report that they have caught some trespassers. It seems they are members of a rather strange local Ganesha cult, and they have been stealing the white elephant's dung for worship.
EVTOPTA_RoI_166	Kill the blasphemers!	Kill the blasphemers!
EVTOPTB_RoI_166	No harm done, give them the droppings as a gift.	No harm done, give them the droppings as a gift.
EVTOPTC_RoI_166	Let them work in the stables. We will pay them with dung.	Let them work in the stables. We will pay them with dung.
EVTDESC_RoI_167	Your white elephant has still not gotten used to its new housing, and it seems restless and bored. Last night it got worse, it started kicking around and going on a rampage, almost tearing the whole place apart.	Your white elephant has still not gotten used to its new housing, and it seems restless and bored. Last night it got worse, it started kicking around and going on a rampage, almost tearing the whole place apart.
EVTOPTA_RoI_167	Just repair it.	Just repair it.
EVTOPTB_RoI_167	I've had enough, return this cursed gift.	I've had enough, return this cursed gift.
EVTOPTC_RoI_167	Sell the damned thing.	Sell the damned thing.
EVTOPTD_RoI_167	This stupid animal needs to die - now.	This stupid animal needs to die - now.
EVTDESC_RoI_168	My [Root.GetLordLady], there is a problem with your white elephant. Yesterday, it broke out from its stable and ran out into to the nearby fields. Once there, it immediately attempted to mate with several elephants - this desire may actually have been the reason for its escape.	My [Root.GetLordLady], there is a problem with your white elephant. Yesterday, it broke out from its stable and ran out into to the nearby fields. Once there, it immediately attempted to mate with several elephants - this desire may actually have been the reason for its escape.
EVTOPTA_RoI_168	From now on, make sure it gets weekly 'exercise'.	From now on, make sure it gets weekly 'exercise'.
EVTOPTB_RoI_168	I've had enough, return the lecherous beast.	I've had enough, return the lecherous beast.
EVTOPTC_RoI_168	Hmm, maybe we could sell it for breeding.	Hmm, maybe we could sell it for breeding.
EVTOPTD_RoI_168	Kill this elephant. Now.	Kill this elephant. Now.
EVTDESC_RoI_169	If you truly wish to kill the White Elephant, you must decide how to proceed, my [Root.GetLordLady]. Whichever method we employ, we should try to make it look like an accident so as to avoid insulting the person who gave it to us.	If you truly wish to kill the White Elephant, you must decide how to proceed, my [Root.GetLordLady]. Whichever method we employ, we should try to make it look like an accident so as to avoid insulting the person who gave it to us.
EVTOPTA_RoI_169	Poison it.	Poison it.
EVTOPTB_RoI_169	Let's just starve it to death.	Let's just starve it to death.
EVTOPTC_RoI_169	Push it over a cliff.	Push it over a cliff.
EVTOPTD_RoI_169	I don't care who's insulted. Send in the soldiers with lances.	I don't care who's insulted. Send in the soldiers with lances.
EVTDESC_RoI_170	The caretakers poison the white elephant's drinking water. The elephant soon starts to wail in pain and becomes quite sick. It is a slow poison, and it takes several days for the beast to expire. Everyone is very concerned and very sad at this sudden 'illness'. No one suspects that you had the elephant poisoned.	The caretakers poison the white elephant's drinking water. The elephant soon starts to wail in pain and becomes quite sick. It is a slow poison, and it takes several days for the beast to expire. Everyone is very concerned and very sad at this sudden 'illness'. No one suspects that you had the elephant poisoned.
EVTOPTA_RoI_170	Excellent.	Excellent.
EVTDESC_RoI_171	The caretakers poison the white elephant's drinking water. The elephant soon starts to wail in pain and becomes quite sick, vomiting blood and dying within minutes. Most people think it very strange that such a healthy animal suddenly died so quickly. Rumor quickly spreads that you had it poisoned.	The caretakers poison the white elephant's drinking water. The elephant soon starts to wail in pain and becomes quite sick, vomiting blood and dying within minutes. Most people think it very strange that such a healthy animal suddenly died so quickly. Rumor quickly spreads that you had it poisoned.
EVTOPTA_RoI_171	Unfortunate.	Unfortunate.
EVTDESC_RoI_172	You instruct the caretakers to stop feeding the elephant. The animal gets progressively weaker and weaker until one morning it is found dead. You have your servants and medics complain loudly about the animal having been sick and refusing to eat. Everyone is sad, but no one suspects foul play.	You instruct the caretakers to stop feeding the elephant. The animal gets progressively weaker and weaker until one morning it is found dead. You have your servants and medics complain loudly about the animal having been sick and refusing to eat. Everyone is sad, but no one suspects foul play.
EVTOPTA_RoI_172	Excellent.	Excellent.
EVTDESC_RoI_173	You instruct the caretakers to stop feeding the elephant. The animal gets progressively weaker and weaker until one morning it is found dead. Word gets out, however, that your servants had stopped delivering food to the stable and soon it is common knowledge that you starved the elephant to death.	You instruct the caretakers to stop feeding the elephant. The animal gets progressively weaker and weaker until one morning it is found dead. Word gets out, however, that your servants had stopped delivering food to the stable and soon it is common knowledge that you starved the elephant to death.
EVTOPTA_RoI_173	Unfortunate.	Unfortunate.
EVTDESC_RoI_174	You arrange to bring the white elephant on an official procession very near some high cliffs. At the right moment, the guards prod the elephant with spears and drive it over the cliff, and it falls to its death. You swiftly have the guards spread the news of the terrible accident. Everyone is shocked, but no one suspects your involvement.	You arrange to bring the white elephant on an official procession very near some high cliffs. At the right moment, the guards prod the elephant with spears and drive it over the cliff, and it falls to its death. You swiftly have the guards spread the news of the terrible accident. Everyone is shocked, but no one suspects your involvement.
EVTOPTA_RoI_174	Excellent.	Excellent.
EVTDESC_RoI_175	You arrange to bring the white elephant on an official procession very near some high cliffs. At the right moment, the guards prod the elephant with spears and drive it over the cliff, and it falls to its death. Unluckily, however, some hunters passing by witnessed the whole incident, and rumor of your bloody deed swiftly spread throughout the realm.	You arrange to bring the white elephant on an official procession very near some high cliffs. At the right moment, the guards prod the elephant with spears and drive it over the cliff, and it falls to its death. Unluckily, however, some hunters passing by witnessed the whole incident, and rumor of your bloody deed swiftly spread throughout the realm.
EVTOPTA_RoI_175	Unfortunate.	Unfortunate.
EVTDESC_RoI_176	You send twenty soldiers armed with lances into the white elephant's stable. They attack and swiftly kill the animal in a few very noisy and bloody moments. Everyone knows it was done on your direct orders, and that's exactly the way you want it to be.	You send twenty soldiers armed with lances into the white elephant's stable. They attack and swiftly kill the animal in a few very noisy and bloody moments. Everyone knows it was done on your direct orders, and that's exactly the way you want it to be.
EVTOPTA_RoI_176	It had to be done.	It had to be done.
EVTDESC_RoI_177	The white elephant seems to be a lot calmer now, and hasn't broken anything or injured anyone in quite a while. It seems that perhaps our troubles with it are over.	The white elephant seems to be a lot calmer now, and hasn't broken anything or injured anyone in quite a while. It seems that perhaps our troubles with it are over.
EVTOPTA_RoI_177	Let's hope so.	Let's hope so.
EVTDESC_RoI_180	A group of wandering Buddhist monks have come to visit the province. They are staging impressive shows of acrobatic unarmed fighting techniques in the villages.	A group of wandering Buddhist monks have come to visit the province. They are staging impressive shows of acrobatic unarmed fighting techniques in the villages.
EVTOPTA_RoI_180	Those guys are fast as lightning!	Those guys are fast as lightning!
EVTOPTB_RoI_180	They had better not teach those things to my peasants.	They had better not teach those things to my peasants.
EVTOPTD_RoI_245	I think I know who it was...	I think I know who it was...
EVTDESC_RoI_190	A strange man has approached you, seeking audience with you. He claims he is an 'engineer' and he wishes to build a boat that can travel under water and sail it up the Indus. All he needs is a sponsor for the project. If you help him, he will name the boat after you - 'a you-boat', he jokes, smiling nervously.	A strange man has approached you, seeking audience with you. He claims he is an 'engineer' and he wishes to build a boat that can travel under water and sail it up the Indus. All he needs is a sponsor for the project. If you help him, he will name the boat after you - 'a you-boat', he jokes, smiling nervously.
EVTOPTA_RoI_190	Interesting. How much money do you need?	Interesting. How much money do you need?
EVTOPTB_RoI_190	'You-boat?' Get out. Now.	You-boat?' Get out. Now.
EVTDESC_RoI_191	The 'engineer' spent many days building his underwater boat. In the end it was finished and he set out, submerging the craft to the sound of amazed murmuring from the great crowd gathered along the shore. A faint trail of bubbles could be seen as the boat navigated underwater up the river.\nAlas, he was never seen nor heard of again.	The 'engineer' spent many days building his underwater boat. In the end it was finished and he set out, submerging the craft to the sound of amazed murmuring from the great crowd gathered along the shore. A faint trail of bubbles could be seen as the boat navigated underwater up the river.\nAlas, he was never seen nor heard of again.
EVTOPTA_RoI_191	Hmm, what have we learned from this?	Hmm, what have we learned from this?
EVTDESC_RoI_193	It is rumored that a sacred yogi has mastered the art of levitation, and that he can be seen at a marketplace nearby.	It is rumored that a sacred yogi has mastered the art of levitation, and that he can be seen at a marketplace nearby.
EVTOPTA_RoI_193	I must see this!	I must see this!
EVTOPTB_RoI_193	I have no time for superstitions.	I have no time for superstitions.
EVTDESC_RoI_194	You arrive at the marketplace. There is a large crowd gathered around the yogi. He does indeed seem to be levitating above the ground, eyes closed. Someone mutters that he has been still like that for several hours.	You arrive at the marketplace. There is a large crowd gathered around the yogi. He does indeed seem to be levitating above the ground, eyes closed. Someone mutters that he has been still like that for several hours.
EVTOPTA_RoI_194	Interesting.	Interesting.
EVTOPTB_RoI_194	Fascinating! I must donate money to this holy man.	Fascinating! I must donate money to this holy man.
EVTOPTC_RoI_194	Let's poke him and see what happens.	Let's poke him and see what happens.
EVTOPTD_RoI_194	I think I'll give him a hard shove.	I think I'll give him a hard shove.
EVTDESC_RoI_195	You leave the levitating yogi, pondering the magical mysteries of these holy men.	You leave the levitating yogi, pondering the magical mysteries of these holy men.
EVTOPTA_RoI_195	The world holds so many fantastic things.	The world holds so many fantastic things.
EVTDESC_RoI_196	You poke the yogi. He blinks, then regains his composure.	You poke the yogi. He blinks, then regains his composure.
EVTOPTA_RoI_196	Poke him again.	Poke him again.
EVTOPTB_RoI_196	Leave him alone.	Leave him alone.
EVTOPTC_RoI_196	Give him a good shove.	Give him a good shove.
EVTDESC_RoI_197	The yogi opens his eyes, irritated. He steps down and leaves without a word. The rest of the crowd eyes you with disapproval.	The yogi opens his eyes, irritated. He steps down and leaves without a word. The rest of the crowd eyes you with disapproval.
EVTOPTA_RoI_197	What?	What?
EVTDESC_RoI_198	You take step back, then throw yourself forward, giving the yogi a forceful shove. He topples over with a frightened screech, hitting his head on the ground. The crowd stares in stunned silence at you and the yogi.	You take step back, then throw yourself forward, giving the yogi a forceful shove. He topples over with a frightened screech, hitting his head on the ground. The crowd stares in stunned silence at you and the yogi.
EVTOPTA_RoI_198	I knew he was a fake!	I knew he was a fake!
EVTDESC_RoI_158	An elephant has gone crazy and is running amuck in the town outside the castle. It has already killed several people - what shall we do?	An elephant has gone crazy and is running amuck in the town outside the castle. It has already killed several people - what shall we do?
EVTOPTA_RoI_158	Send soldiers to kill it.	Send soldiers to kill it.
EVTOPTB_RoI_158	Try to capture it.	Try to capture it.
EVTDESC_RoI_159	Several soldiers were severely injured, but they managed to kill the elephant. The animal died screaming, spilling a whole river of blood all over the street. The peasants are very upset.	Several soldiers were severely injured, but they managed to kill the elephant. The animal died screaming, spilling a whole river of blood all over the street. The peasants are very upset.
EVTOPTA_RoI_159	Well, at least the town is safe now.	Well, at least the town is safe now.
EVTDESC_RoI_160	The soldiers managed to lure the elephant to a safe area and then kill it with spears.	The soldiers managed to lure the elephant to a safe area and then kill it with spears.
EVTOPTA_RoI_160	Ah, good.	Ah, good.
EVTDESC_RoI_161	It was impossible to capture the crazed beast. It killed several more people, flattened a couple of buildings and then ran off into the countryside.	It was impossible to capture the crazed beast. It killed several more people, flattened a couple of buildings and then ran off into the countryside.
EVTOPTA_RoI_161	Unfortunate.	Unfortunate.
EVTDESC_RoI_162	A couple of veteran elephant handlers managed to snare and capture the elephant. It has been brought safely to the pens.	A couple of veteran elephant handlers managed to snare and capture the elephant. It has been brought safely to the pens.
EVTOPTA_RoI_162	Excellent!	Excellent!
EVTDESC_RoI_400	It seems that my interest in the Indian religions has come to the attention of one of their practitioners within the realm. We met and have had the most fruitful discussions about theology and other matters.	It seems that my interest in the Indian religions has come to the attention of one of their practitioners within the realm. We met and have had the most fruitful discussions about theology and other matters.
EVTOPTA_RoI_400	I have made a friend!	I have made a friend!
EVTDESC_RoI_401	You have received a visitor - an emissary from the famous university at Nalanda. He tells of you of the research and other work they do there and offers you a formal invitation to visit and see this marvel of Bihar.	You have received a visitor - an emissary from the famous university at Nalanda. He tells of you of the research and other work they do there and offers you a formal invitation to visit and see this marvel of Bihar.
EVTOPTA_RoI_401	Interesting - I will accept the invitation.	Interesting - I will accept the invitation.
EVTOPTB_RoI_401	I don't have the time.	I don't have the time.
EVTNAME_RoI_402	Nalanda	Nalanda
EVTDESC_RoI_402	You have arrived at the magnificent University of Nalanda. It's a massive complex of red brick buildings, busy with a bustle of scholars and monks. You have been told that people come here from all over India and beyond in order to study and exchange ideas. The library has a huge amount of texts in every language known to man.\n\nIt's an impresssive place. You don't have much time to spend here, however, so you need to decide what to do...	You have arrived at the magnificent University of Nalanda. It's a massive complex of red brick buildings, busy with a bustle of scholars and monks. You have been told that people come here from all over India and beyond in order to study and exchange ideas. The library has a huge amount of texts in every language known to man.\n\nIt's an impresssive place. You don't have much time to spend here, however, so you need to decide what to do...
EVTOPTA_RoI_402	I will focus on studying the architecture.	I will focus on studying the architecture.
EVTOPTB_RoI_402	I think I will spend a few days in the library.	I think I will spend a few days in the library.
EVTOPTC_RoI_402	I have come to receive religious instruction.	I have come to receive religious instruction.
become_samrat_chakravartin	Become Samrat Chakravartin	Become Samrat Chakravartin
become_samrat_chakravartin_desc	An Indian ruler who manages to emulate Ashoka the Great and unite all the lands of India under [Root.GetHerHis] rule may claim the title of Samrat Chakravartin, Emperor of Emperors. This title embodies the concept of the ideal and universal world ruler in Indian tradition. Claiming it is a hard task, but living up to it may be even harder...	An Indian ruler who manages to emulate Ashoka the Great and unite all the lands of India under [Root.GetHerHis] rule may claim the title of Samrat Chakravartin, Emperor of Emperors. This title embodies the concept of the ideal and universal world ruler in Indian tradition. Claiming it is a hard task, but living up to it may be even harder...
has_court_guru	Court Guru	Court Guru
nick_the_leper	the Leper	the Leper
PEACE	Peace	Peace
d_tamil_band	Tamil Band	Tamil Band
d_tamil_band_adj	Tamil	Tamil
d_marathi_company	Marathi Company	Marathi Company
d_marathi_company_adj	Marathi	Marathi
d_marathi_band	Marathi Band	Marathi Band
d_marathi_band_adj	Marathi	Marathi
d_bengal_company	Bengal Company	Bengal Company
d_bengal_company_adj	Bengal	Bengal
d_bengal_band	Bengal Band	Bengal Band
d_bengal_band_adj	Bengal	Bengal
d_rajput_company	Rajput Company	Rajput Company
d_rajput_company_adj	Rajput	Rajput
d_rajput_band	Rajput Band	Rajput Band
d_rajput_band_adj	Rajput	Rajput
TRAIT_OPINION_CHURCH	Church Opinion: $VALUE$	Church Opinion: $VALUE$
TRAIT_OPINION_CHRISTIAN_CHURCH	Christian Church Opinion: $VALUE$	Christian Church Opinion: $VALUE$
TRAIT_OPINION_SPOUSE	Spouse Opinion: $VALUE$	Spouse Opinion: $VALUE$
TRAIT_OPINION_SEX_APPEAL	Attraction Opinion: $VALUE$	Attraction Opinion: $VALUE$
TRAIT_OPINION_DYNASTY	Dynasty Opinion: $VALUE$	Dynasty Opinion: $VALUE$
TRAIT_OPINION_VASSAL	Vassal Opinion: $VALUE$	Vassal Opinion: $VALUE$
TRAIT_OPINION_LIEGE	Liege Opinion: $VALUE$	Liege Opinion: $VALUE$
TRAIT_OPINION_INFIDEL	Other Faith Opinion: $VALUE$	Other Faith Opinion: $VALUE$
TRAIT_OPINION_SAME_TRAIT	Same Trait Opinion: $VALUE$	Same Trait Opinion: $VALUE$
TRAIT_OPINION_SAME_TRAIT_SAME_REL	Religious Same Trait Opinion: $VALUE$	Religious Same Trait Opinion: $VALUE$
TRAIT_OPINION_OPPOSITE_TRAIT	Opposite Trait Opinion: $VALUE$	Opposite Trait Opinion: $VALUE$
TRAIT_OPINION_SAME_RELIGION	Same Faith Opinion: $VALUE$	Same Faith Opinion: $VALUE$
TRAIT_OPINION_MUSLIM	Muslim Opinion: $VALUE$	Muslim Opinion: $VALUE$
TRAIT_OPINION_ZORO	Zoroastrian Opinion: $VALUE$	Zoroastrian Opinion: $VALUE$
TRAIT_OPINION_JEWISH	Jewish Opinion: $VALUE$	Jewish Opinion: $VALUE$
TRAIT_OPINION_CHRISTIAN	Christian Opinion: $VALUE$	Christian Opinion: $VALUE$
TRAIT_OPINION_AMBITION	Ambition Opinion: $VALUE$	Ambition Opinion: $VALUE$
indian_has_not_converted	Has not already converted	Has not already converted
EVTDESC_RoI_1080	Tempers flaring at the feast! A duel broke out between [FromFromFrom.GetFullName] and [FromFrom.GetFullName], and the ringing of steel on steel held the spectators captive for several intense moments.\n\n[FromFrom.GetFullName] lost but he suffered only minor wounds.	Tempers flaring at the feast! A duel broke out between [FromFromFrom.GetFullName] and [FromFrom.GetFullName], and the ringing of steel on steel held the spectators captive for several intense moments.\n\n[FromFrom.GetFullName] lost but he suffered only minor wounds.
EVTDESC_RoI_1081	Tempers flaring at the feast! A duel broke out between [FromFromFrom.GetFullName] and [FromFrom.GetFullName], and the ringing of steel on steel held the spectators captive for several intense moments.\n\n[FromFrom.GetFullName] lost and lies wounded on the ground.	Tempers flaring at the feast! A duel broke out between [FromFromFrom.GetFullName] and [FromFrom.GetFullName], and the ringing of steel on steel held the spectators captive for several intense moments.\n\n[FromFrom.GetFullName] lost and lies wounded on the ground.
EVTDESC_RoI_1082	Tempers flaring at the feast! A duel broke out between [FromFromFrom.GetFullName] and [FromFrom.GetFullName], and the ringing of steel on steel held the spectators captive for several intense moments.\n\n[FromFrom.GetFullName] lost and was horribly maimed.	Tempers flaring at the feast! A duel broke out between [FromFromFrom.GetFullName] and [FromFrom.GetFullName], and the ringing of steel on steel held the spectators captive for several intense moments.\n\n[FromFrom.GetFullName] lost and was horribly maimed.
EVTDESC_RoI_1083	Tempers flaring at the feast! A duel broke out between [FromFromFrom.GetFullName] and [FromFrom.GetFullName], and the ringing of steel on steel held the spectators captive for several intense moments.\n\n[FromFrom.GetFullName] was killed!	Tempers flaring at the feast! A duel broke out between [FromFromFrom.GetFullName] and [FromFrom.GetFullName], and the ringing of steel on steel held the spectators captive for several intense moments.\n\n[FromFrom.GetFullName] was killed!
EVTDESC_RoI_3202	Lately, you have been enganging in long philosophical conversations with [From.GetFirstNameWithNick], your court guru. You have been discussing Buddhism, and how you can become master over your desires and weaknessess and eliminate the suffering they cause in your soul.	Lately, you have been enganging in long philosophical conversations with [From.GetFirstNameWithNick], your court guru. You have been discussing Buddhism, and how you can become master over your desires and weaknessess and eliminate the suffering they cause in your soul.
EVTOPTA_RoI_3202	I feel I have been helped by this!	I feel I have been helped by this!
EVTOPTB_RoI_3202	It's no use!	It's no use!
obj_buddhist_stop_drinking_title	Stop Drinking	Stop Drinking
obj_buddhist_stop_drinking_desc	[This.GetTitledFirstName], as a devoted Buddhist, is trying to learn to abandon [This.GetHerHis] harmful drinking habits.	[This.GetTitledFirstName], as a devoted Buddhist, is trying to learn to abandon [This.GetHerHis] harmful drinking habits.
obj_buddhist_reject_empty_pleasures_title	Learn to Reject Empty Pleasures	Learn to Reject Empty Pleasures
obj_buddhist_reject_empty_pleasures_desc	[This.GetTitledFirstName], as a devoted Buddhist, is trying to learn to reject emply pleasures.	[This.GetTitledFirstName], as a devoted Buddhist, is trying to learn to reject emply pleasures.
obj_buddhist_abstain_sexual_excess_title	Learn to Abstain from Excesses of the Flesh	Learn to Abstain from Excesses of the Flesh
obj_buddhist_abstain_sexual_excess_desc	[This.GetTitledFirstName], as a devoted Buddhist, is trying to learn to abstain from excesses of the flesh.	[This.GetTitledFirstName], as a devoted Buddhist, is trying to learn to abstain from excesses of the flesh.
obj_buddhist_reject_cruelty_title	Reject Cruelty	Reject Cruelty
obj_buddhist_reject_cruelty_desc	[This.GetTitledFirstName], as a devoted Buddhist, is trying to learn to reject cruelty.	[This.GetTitledFirstName], as a devoted Buddhist, is trying to learn to reject cruelty.
obj_buddhist_temperance_food_title	Learn Temperance with Food	Learn Temperance with Food
obj_buddhist_temperance_food_desc	[This.GetTitledFirstName], as a devoted Buddhist, is trying to learn to eat without excess.	[This.GetTitledFirstName], as a devoted Buddhist, is trying to learn to eat without excess.
obj_buddhist_reject_greed_title	Learn to Reject the Poison of Greed	Learn to Reject the Poison of Greed
obj_buddhist_reject_greed_desc	[This.GetTitledFirstName], as a devoted Buddhist, is trying to learn to reject the poison that greed brings to the mind.	[This.GetTitledFirstName], as a devoted Buddhist, is trying to learn to reject the poison that greed brings to the mind.
obj_buddhist_reject_envy_title	Learn to Reject Envy	Learn to Reject Envy
obj_buddhist_reject_envy_desc	[This.GetTitledFirstName], as a devoted Buddhist, is trying to learn to reject the poison that envy brings to the mind.	[This.GetTitledFirstName], as a devoted Buddhist, is trying to learn to reject the poison that envy brings to the mind.
obj_buddhist_reject_hate_title	Learn to Reject Hate	Learn to Reject Hate
obj_buddhist_reject_hate_desc	[This.GetTitledFirstName], as a devoted Buddhist, is trying to learn to reject the poison that hate and anger brings to the mind.	[This.GetTitledFirstName], as a devoted Buddhist, is trying to learn to reject the poison that hate and anger brings to the mind.
obj_buddhist_reject_pride_title	Learn to Reject Pride	Learn to Reject Pride
obj_buddhist_reject_pride_desc	[This.GetTitledFirstName], as a devoted Buddhist, is trying to learn to reject pride.	[This.GetTitledFirstName], as a devoted Buddhist, is trying to learn to reject pride.
obj_buddhist_defeat_fear_title	Defeat Fear	Defeat Fear
obj_buddhist_defeat_fear_desc	[This.GetTitledFirstName], as a devoted Buddhist, is trying to learn to defeat [This.GetHerHis] fear of the world and of the designs of others.	[This.GetTitledFirstName], as a devoted Buddhist, is trying to learn to defeat [This.GetHerHis] fear of the world and of the designs of others.
temple_barony_of_hindu	Mandir of	Mandir of
temple_barony_of_buddhist	Vihara of	Vihara of
temple_barony_of_jain	Derasar of	Derasar of
DEATH_SACRIFICED	was offered up in sacrifice to the Gods by $KILLER$	was offered up in sacrifice to Pagan gods by $KILLER$
obj_become_paragon_of_enlightenment_title	Become Paragon of Enlightenment	Become Paragon of Enlightenment
obj_become_paragon_of_enlightenment_desc	[This.GetTitledFirstName] strives to improve [This.GetHerHis] [This.Religion.GetPietyName] and become enlightened, an inspiration to all of [This.GetHerHis] faith.	[This.GetTitledFirstName] strives to improve [This.GetHerHis] [This.Religion.GetPietyName] and become enlightened, an inspiration to all of [This.GetHerHis] faith.
opinion_enlightened	Enlightened	Enlightened
paragon_of_enlightenment	Paragon of Enlightenment	Paragon of Enlightenment
EVTTOOLTIP1_RoI_2001	Reply is sent to [From.GetFullName]	Reply is sent to [From.GetFullName]
brahmin_desc	This character belongs to the Brahmin caste. It is the Indian caste of priests and scholars, highest in the caste hierarchy.	This character belongs to the Brahmin caste. It is the Indian caste of priests and scholars, highest in the caste hierarchy.
kshatriya_desc	This character belongs to the Kshatriya caste. It is the Indian caste of warriors and kings, second in the caste hierarchy.	This character belongs to the Kshatriya caste. It is the Indian caste of warriors and kings, second in the caste hierarchy.
vaishya_desc	This character belongs to the Vaishya caste. It is the Indian caste of traders and artisans, third in the caste hierarchy.	This character belongs to the Vaishya caste. It is the Indian caste of traders and artisans, third in the caste hierarchy.
convert_indian_branch	Change Religious Branch	Change Religious Branch
jain_ahimsa_tooltip	This act violates the Jain doctrine of Ahimsa, or non-violence\n	This act violates the Jain doctrine of Ahimsa, or non-violence
ARRANGE_MARRIAGE_DESC	Arrange a marriage with one of the most eligible potential spouses available.	Arrange a marriage with one of the most eligible potential spouses available.
alert_demesne_too_big_instant	§YDemesne too Big§!	§YDemesne too Big§!
alert_demesne_too_big_delayed	Your demesne has §Y$NUM$§!/§Y$MAX$§! holdings, causing inefficient taxation, troop recruitment and resentment among your vassals.	Your demesne has §Y$NUM$§!/§Y$MAX$§! holdings, causing inefficient taxation, troop recruitment and resentment among your vassals.
horse_archers_modifier	Combat Modifier boost to Horse Archer Troops: $PERC$	Combat Modifier boost to Horse Archer Troops: $PERC$
camel_cavalry_modifier	Combat Modifier boost to Camel Mounted Troops: $PERC$	Combat Modifier boost to Camel Mounted Troops: $PERC$
war_elephants_modifier	Combat Modifier boost to Elephant Mounted Troops: $PERC$	Combat Modifier boost to Elephant Mounted Troops: $PERC$
EVTDESC_RoI_500	Some traveling merchants from Europe have arrived, seeking audience. They say they are from Venice and are on a long journey to reach the court of the Khan in in the far east.	Some traveling merchants from Europe have arrived, seeking audience. They say they are from Venice and are on a long journey to reach the court of the Khan in in the far east.
EVTOPTA_RoI_500	Bring them before me, I shall speak to them.	Bring them before me, I shall speak to them.
EVTOPTB_RoI_500	These people do not interest me. Send them away.	These people do not interest me. Send them away.
EVTDESC_RoI_501	The merchants turn out to be brothers, going by the names of Niccoló Polo and Matteo Polo, and Niccoló's son Marco is also traveling with them. They petition you to provide an escort or guides for travelling east through your realm.	The merchants turn out to be brothers, going by the names of Niccoló Polo and Matteo Polo, and Niccoló's son Marco is also traveling with them. They petition you to provide an escort or guides for travelling east through your realm.
EVTOPTA_RoI_501	I will provide seasoned guides.	I will provide seasoned guides.
EVTOPTB_RoI_501	I will provide seasoned guides and an armed escort.	I will provide seasoned guides and an armed escort.
EVTOPTC_RoI_501	I'm sure they they can manage on their own.	I'm sure they they can manage on their own.
EVTDESC_RoI_502	The Polo brothers thank you gratefully for your assistance. The next day they set off eastwards, strengthened by the aid you have provided.	The Polo brothers thank you gratefully for your assistance. The next day they set off eastwards, strengthened by the aid you have provided.
EVTOPTA_RoI_502	I wish them a good journey.	I wish them a good journey.
EVTDESC_RoI_503	The Polo brothers thank you for the audience. After spending the night in town, they set off again the next day.	The Polo brothers thank you for the audience. After spending the night in town, they set off again the next day.
EVTOPTA_RoI_503	What strange men.	What strange men.
EVTDESC_RoI_504	You have received an unexpected visit! The Venetian merchants Niccoló, Matteo and Marco Polo have once again arrived at your court. They explain that they reached the Far East and are now returning after a successful voyage, wanting to stop at your palace to thank you for the valuable aid you offered when they last came by. And they have brought gifts.	You have received an unexpected visit! The Venetian merchants Niccoló, Matteo and Marco Polo have once again arrived at your court. They explain that they reached the Far East and are now returning after a successful voyage, wanting to stop at your palace to thank you for the valuable aid you offered when they last came by. And they have brought gifts.
EVTOPTA_RoI_504	Come, tell me tales of the East, my friends...	Come, tell me tales of the East, my friends...
EVTDESC_RoI_3302	[From.GetFirstNameWithNick], your Court Guru, has been very keen to discuss matters of society and tradition with you lately. He expresses his views that the caste system is destructive and inhuman, and that men and women should be treated as equals. He even suggests that you become a champion of change by inviting the poor and the casteless to dine with you at your table.	[From.GetFirstNameWithNick], your Court Guru, has been very keen to discuss matters of society and tradition with you lately. He expresses his views that the caste system is destructive and inhuman, and that men and women should be treated as equals. He even suggests that you become a champion of change by inviting the poor and the casteless to dine with you at your table.
EVTOPTA_RoI_3302	What nonsense!	What nonsense!
EVTOPTB_RoI_3302	You are too wise for this age, my friend.	You are too wise for this age, my friend.
EVTTITLE_RoI_3402	Guru meditation	Guru meditation
EVTDESC_RoI_3402	In order to reach inner peace and become a stronger and more harmonious person, you have been practising meditation with your guru, [From.GetFirstNameWithNick].\n\nYou have spent many moments reaching for your inner self, focusing, breathing, finding tranquility and harmony. You contemplate yourself within the universe, the universe within yourself, and your place in time and outside time.\n\nAnd little by little, you are beginning to feel the difference.	In order to reach inner peace and become a stronger and more harmonious person, you have been practising meditation with your guru, [From.GetFirstNameWithNick].\n\nYou have spent many moments reaching for your inner self, focusing, breathing, finding tranquility and harmony. You contemplate yourself within the universe, the universe within yourself, and your place in time and outside time.\n\nAnd little by little, you are beginning to feel the difference.
EVTOPTA_RoI_3402	Om bhur bhuvah svah.	Om bhur bhuvah svah.
EVTOPTB_RoI_3402	Om mani padme hum.	Om mani padme hum.
EVTOPTC_RoI_3402	Namo arihantanam.	Namo arihantanam.
EVTOPTK96500	Master Jungle Terrain.	Master Jungle Terrain.
EVTOPTL96500	Focus on War Elephants.	Focus on War Elephants.
EVTDESC_RoI_3505	My [Root.GetLordLady], the province of [From.GetName] is in disarray. There are many reports of deep-set corruption among religious officials of the [Root.Religion.GetName] faith.	My [Root.GetLordLady], the province of [From.GetName] is in disarray. There are many reports of deep-set corruption among religious officials of the [Root.Religion.GetName] faith.
EVTOPTA_RoI_3505	This is most worrying.	This is most worrying.
EVTDESC_RoI_3509	Good news, my [Root.GetLordLady]! Thanks to the resurgence of power of the [Root.Religion.GetName] faith, the corruption in the province of [From.GetName] has been eradicated.	Good news, my [Root.GetLordLady]! Thanks to the resurgence of power of the [Root.Religion.GetName] faith, the corruption in the province of [From.GetName] has been eradicated.
EVTOPTA_RoI_3509	Excellent!	Excellent!
EVTDESC_RoI_3515	My [Root.GetLordLady], there are worrying news from the province of [From.GetName]. The [Root.Religion.GetName] faith is weakening and a strange local death cult have taken over several temples.	My [Root.GetLordLady], there are worrying news from the province of [From.GetName]. The [Root.Religion.GetName] faith is weakening and a strange local death cult have taken over several temples.
EVTOPTA_RoI_3515	This is not good.	This is not good.
EVTDESC_RoI_3519	Good news, my [Root.GetLordLady]! Thanks to the resurgence of power of the [Root.Religion.GetName] faith, the power of the local death cults in the province of [From.GetName] has been eradicated.	Good news, my [Root.GetLordLady]! Thanks to the resurgence of power of the [Root.Religion.GetName] faith, the power of the local death cults in the province of [From.GetName] has been eradicated.
EVTOPTA_RoI_3519	By [Root.Religion.GetRandomGodName], that is good news!	By [Root.Religion.GetRandomGodName], that is good news!
EVTDESC_RoI_3525	Bad news, my [Root.GetLordLady]! The people of [From.GetName] have long been losing faith in the ways of [Root.Religion.GetRandomGodName]. Now the majority of the province's population have switched to the [From.Religion.GetName] faith!	Bad news, my [Root.GetLordLady]! The people of [From.GetName] have long been losing faith in the ways of [Root.Religion.GetRandomGodName]. Now the majority of the province's population have switched to the [From.Religion.GetName] faith!
EVTOPTA_RoI_3525	Bad news indeed!	Bad news indeed!
EVTDESC_RoI_3535	My [Root.GetLordLady], the county of [From.GetName] is experiencing much turmoil due to tensions between different religious factions of the [From.Religion.GetName] faith. It has gone as far as street battles taking place between supporters of different interpretations of [From.Religion.GetScriptureName].	My [Root.GetLordLady], the province of [From.GetName] is experiencing much turmoil due to tensions between different religious factions of the [From.Religion.GetName] faith. It has gone as far as street battles taking place between supporters of different interpretations of [From.Religion.GetScriptureName].
EVTOPTA_RoI_3535	This is the work of [Root.Religion.GetRandomEvilGodName]!	This is the work of [Root.Religion.GetRandomEvilGodName]!
EVTDESC_RoI_3539	Good news, my [Root.GetLordLady]! Thanks to the resurgence of power of the [Root.Religion.GetName] faith, the religious strife in the county of [From.GetName] has ebbed out.	Good news, my [Root.GetLordLady]! Thanks to the resurgence of power of the [Root.Religion.GetName] faith, the religious strife in the province of [From.GetName] has ebbed out.
EVTOPTA_RoI_3539	Finally they see the wisdom of [Root.Religion.GetRandomGodName]!	Finally they see the wisdom of [Root.Religion.GetRandomGodName]!
temple_corruption	Temple Corruption	Temple Corruption
local_death_cult	Local Death Cult	Local Death Cult
MODIFIER_ADD_PIETY	Monthly $PIETYNAME$ gain	Monthly $PIETYNAME$ gain
MONTHLY_CHARACTER_PIETY	Monthly $PIETYNAME$	Monthly $PIETYNAME$
