#CODE	ENGLISH	ENGLISH
#MODIFIER_COMBAT_RATING	Combat Rating	Combat Rating
CR_DIFF_LOWER_THAN	Combat Rating Difference between §Y$FIRST$§! and §Y$SECOND$§! lower than §Y$VAL$§!	Combat Rating Difference between §Y$FIRST$§! and §Y$SECOND$§! lower than §Y$VAL$§!
CR_DIFF_AT_LEAST	Combat Rating Difference between §Y$FIRST$§! and §Y$SECOND$§! at least §Y$VAL$§!	Combat Rating Difference between §Y$FIRST$§! and §Y$SECOND$§! at least §Y$VAL$§!
HAS_CR_AT_LEAST	Combat Rating at least 	Combat Rating at least 
HAS_LOWER_CR_THAN	Combat Rating lower than 	Combat Rating lower than 
MASTER	master	master
MISTRESS	mistress	mistress
wol_schemer_1	Amateur Schemer	Amateur Schemer
desc_wol_schemer_1	This character is an aspiring schemer who seeks to manipulate others through deceit and subterfuge.	This character is an aspiring schemer who seeks to manipulate others through deceit and subterfuge.
wol_schemer_2	Schemer	Schemer
desc_wol_schemer_2	This character is an experienced schemer, plotter and shadowy puppetmaster.	This character is an experienced schemer, plotter and shadowy puppetmaster.
wol_patriarch_1	Family Man	Family Man
desc_wol_patriarch_1	This man is devoted to the harmony and well-being of his family.	This man is devoted to the harmony and well-being of his family.
wol_patriarch_2	Family Patriarch	Family Patriarch
desc_wol_patriarch_2	This man is the undisputed head of the family, resolving conflicts and leading with a firm but gentle hand.	This man is the undisputed head of the family, resolving conflicts and leading with a firm but gentle hand.
wol_matriarch_1	Family Woman	Family Woman
desc_wol_matriarch_1	This woman is devoted to the harmony and well-being of her family.	This woman is devoted to the harmony and well-being of her family.
wol_matriarch_2	Family Matriarch	Family Matriarch
desc_wol_matriarch_2	This woman is the undisputed head of the family, resolving conflicts and leading with a firm but gentle hand.	This woman is the undisputed head of the family, resolving conflicts and leading with a firm but gentle hand.
schemer	Master Schemer	Master Schemer
break_up_with_lover	Break Up	Break up
break_up_with_lover_desc	Your love affair with §Y[Root.GetTitledFirstNameNoRegnal]§! is ended.	Your love affair with [Root.GetTitledFirstNameNoRegnal] is ended.
opinion_whorespawn	Whorespawn	Whorespawn
opinion_seduced_once	Seduced	Seduced
opinion_seduced_lustful_worship	Lustful Worship	Lustful Worship
opinion_seducing_concubine	Seducing	Seducing
opinion_regicide_traitor	Murderous Traitor	Murderous Traitor
seduced_loyal_bodyguard	Bodyguard Lover	Bodyguard Lover
desc_seduced_loyal_bodyguard	Through seduction, this character has secured the most loyal bodyguard imaginable.	Through seduction, this character has secured the most loyal bodyguard imaginable.
seduced_loyal_spy_maid	Maidservant Lover	Maidservant Lover
desc_seduced_loyal_spy_maid	This character has seduced a maid with a quick mind and an ample bosom, using her to spy and snoop around at court.	This character has seduced a maid with a quick mind and an ample bosom, using her to spy and snoop around at court.
minor_disease_herpes	Lover's Pox	Lover's Pox
desc_minor_disease_herpes	This character periodically suffers from embarrassing and unsightly blisters.	This character periodically suffers from embarrassing and unsightly blisters.
DAMNATION	Damnation	Damnation
EVTDESC6031_ALL	As the [Root.Religion.GetPriestTitle] slowly pulled me out of the holy spring, the water started boiling and frothing, paint running off the arcane runes smeared on my naked body. Filled with wonder, I realized that the gibbering voices in my head had finally fallen silent!	As the [Root.Religion.GetPriestTitle] slowly pulled me out of the holy spring, the water started boiling and frothing, paint running off the arcane runes smeared on my naked body. Filled with wonder, I realized that the gibbering voices in my head had finally fallen silent!
EVTDESC38309	The fog in my mind has lifted. I realize now that I used to be a Lunatic!	The fog in my mind has lifted. I realize now that I used to be a Lunatic!
EVTDESC38310	I have lost my absolute convictions and try to keep an open mind. I have lost the Zealous trait.	I have lost my absolute convictions and try to keep an open mind. I have lost the Zealous trait.
EVTDESC38311	My frank bluntness won't get me into trouble anymore - I have lost the Honest trait.	My frank bluntness won't get me into trouble anymore - I have lost the Honest trait.
EVTDESC38312	I have learned to take pride in my actions and in my great family. I have lost the Humble trait.	I have learned to take pride in my actions and in my great family. I have lost the Humble trait.
EVTOPTC64130	Life is good!	Life is good!
EVTDESC_WOL_40	This morning I woke up with a painful itch. It seems [Root.Religion.GetRandomGodName] has seen fit to blight me with a minor pox for my sinful activities.	This morning I woke up with a painful itch. It seems [Root.Religion.GetRandomGodName] has seen fit to blight me with a minor pox for my sinful activities.
EVTDESC_WOL_40_NC	This morning I woke up with a painful itch... It seems I have contracted Lover's Pox.	This morning I woke up with a painful itch... it seems I have contracted Lover's Pox.
EVTDESC_WOL_500	My confessor, [target_priest.GetTitledName] is such an attractive [target_priest.GetManWoman]! I've applied my ample charms and can tell [target_priest.GetSubjectPronoun] is thinking of other things than [target_priest.Religion.GetRandomGodName]!	My confessor, [target_priest.GetTitledName] is such an attractive [target_priest.GetManWoman]! I've applied my ample charms and can tell [target_priest.GetSubjectPronoun] is thinking of other things than [target_priest.Religion.GetRandomGodName]!
EVTOPTA_WOL_500	Give [target_priest.GetObjectPronoun] a taste of what [target_priest.GetSubjectPronoun] is missing!	Give [target_priest.GetObjectPronoun] a taste of what [target_priest.GetSubjectPronoun] is missing!
EVTOPTB_WOL_500	I do so love teasing the dear [target_priest.GetManWoman]...	I do so love teasing the dear [target_priest.GetManWoman]...
EVTDESC_WOL_520	Recently, I have amused myself with seducing a handsome young guard. He follows me around like a puppy now... a very big, muscular puppy!	Recently, I have amused myself with seducing a handsome young guard. He follows me around like a puppy now... a very big, muscular puppy!
EVTOPTA_WOL_520	Make him a squire and keep him as my lover...	Make him a squire and keep him as my lover...
EVTOPTB_WOL_520	Give him a tumble and I'll have the most loyal bodyguard ever!	Give him a tumble and I'll have the most loyal bodyguard ever!
EVTOPTC_WOL_520	It's been fun, but I should aim higher.	It's been fun, but I should aim higher.
EVTDESC_WOL_530	I've had my eye on a feisty young scullery maid with huge... intellect for some time now. Though she skillfully dodges the attentions of every boy and greybeard at court, I have her blushing furiously whenever I gaze into her eyes. Seduced and wrapped around my finger, this sharp lass could be very useful...	I've had my eye on a feisty young scullery maid with huge... intellect for some time now. Though she skillfully dodges the attentions of every boy and greybeard at court, I have her blushing furiously whenever I gaze into her eyes. Seduced and wrapped around my finger, this sharp lass could be very useful...
EVTOPTA_WOL_530	Make her a lady and keep her as my mistress...	Make her a lady and keep her as my mistress...
EVTOPTB_WOL_530	Bed her and make her mine. What a spy she'll make!	Bed her and make her mine. What a spy she'll make!
EVTOPTC_WOL_530	A common wench? I can do better!	A common wench? I can do better!
##		
##		
##		
##		
##		
##		
##		
##		
##		
##		
##		
EVTDESC_WOL_560	I see her flit past out of the corner of my eye, naked and red-haired, giggling - the nymph who lives in the garden. Always teasing me, never showing herself clearly. What must I do to win her heart?	I see her flit past out of the corner of my eye, naked and red-haired, giggling - the nymph who lives in the garden. Always teasing me, never showing herself clearly. What must I do to win her heart?
EVTOPTA_WOL_560	The magnificent old rose bush! She must be its spirit.	The magnificent old rose bush! She must be its spirit.
EVTOPTB_WOL_560	Wait... why am I out here in my smallclothes at this hour?	Wait... why am I out here in my smallclothes at this hour?
EVTTOOLTIP_WoL_561	You enter the rose bush, professing your love.	You enter the rose bush, professing your love.
EVTDESC_WOL_561	When I staggered out of the rose bush hours had passed, my head filled with carnal but vague memories. I am bleeding all over from the cruel thorns. The voluptuous dryad has exacted her price...	When I staggered out of the rose bush hours had passed, my head filled with carnal but vague memories. I am bleeding all over from the cruel thorns. The voluptuous dryad has exacted her price...
EVTOPTA_WOL_561	Will I ever see her again?	Will I ever see her again?
EVTDESC_WOL_562	Today the servants found a newborn baby in a basket under the magical rose bush of my dryad lover!	Today the servants found a newborn baby in a basket under the magical rose bush of my dryad lover!
EVTOPTA_WOL_562	Proclaim that little [target_baby.GetFirstName] is my [target_baby.GetSonDaughter]!	Proclaim that little [target_baby.GetFirstName] is my [target_baby.GetSonDaughter]!
EVTOPTB_WOL_562	[target_baby.GetFirstName] will be well cared for.	[target_baby.GetFirstName] will be well cared for.
EVTDESC_WOL_570	The centaur beckons to me, massive muscles flexing. I have never seen anything more masculine in my life!	The centaur beckons to me, massive muscles flexing. I have never seen anything more masculine in my life!
EVTOPTA_WOL_570	I am overcome by his musky scent.	I am overcome by his musky scent.
EVTOPTB_WOL_570	Wait... a centaur? In our stables?!	Wait... a centaur? In our stables?!
EVTTOOLTIP_WoL_571	You succumb to your desires.	You succumb to your desires.
EVTDESC_WOL_571	I came to in a state of bliss, mind filled with foggy images of the stunningly handsome centaur and our night of passion.	I came to in a state of bliss, mind filled with foggy images of the stunningly handsome centaur and our night of passion.
EVTOPTA_WOL_571	Will I ever see him again?	Will I ever see him again?
EVTDESC_WOL_580	The misery of my captivity is only broken when I get to apply my charms on the gaoler. I can tell the ugly lout desires me... perhaps I can exploit his weakness to escape?	The misery of my captivity is only broken when I get to apply my charms on the gaoler. I can tell the ugly lout desires me... perhaps I can exploit his weakness to escape?
EVTOPTA_WOL_580	Come here, handsome!'	Come here, handsome!'
EVTOPTB_WOL_580	It is too risky.	It is too risky.
EVTDESC_WOL_581	The gaoler unlocked the cell and entered, leering. As he started to fondle me, I suggested heading to a more romantic location. He burst out laughing, slapped me on the rump and left, snickering scornfully.	The gaoler unlocked the cell and entered, leering. As he started to fondle me, I suggested heading to a more romantic location. He burst out laughing, slapped me on the rump and left, snickering scornfully.
EVTOPTA_WOL_581	I am sure his [Root.Host.GetMasterMistress], [Root.Host.GetTitledFirstNameNoRegnal], will hear of this...	I am sure his [Root.Host.GetMasterMistress], [Root.Host.GetTitledFirstNameNoRegnal], will hear of this...
EVTDESC_WOL_582	My prisoner, [From.GetTitledName], attempted to use her female charms on the gaoler to escape. Fortunately, he did not fall for her wiles.	My prisoner, [From.GetTitledName], attempted to use her female charms on the gaoler to escape. Fortunately, he did not fall for her wiles.
EVTOPTA_WOL_582	Spunky! I say she has earned better quarters.	Spunky! I say she has earned better quarters.
EVTOPTB_WOL_582	Reward the gaoler for his integrity.	Reward the gaoler for his integrity.
EVTOPTC_WOL_582	The [GetRootFromInsult]! Throw her in the oubliette.	The [GetRootFromInsult]! Throw her in the oubliette.
EVTDESC_WOL_583	[From.GetTitledFirstNameNoRegnal] was so impressed by my initiative with the gaoler that [From.GetSubjectPronoun] personally escorted me out of the dungeon to better accomodations. It should be easier to escape from here...	[From.GetTitledFirstNameNoRegnal] was so impressed by my initiative with the gaoler that [From.GetSubjectPronoun] personally escorted me out of the dungeon to better accomodations. It should be easier to escape from here...
EVTOPTA_WOL_583	I am grateful.	I am grateful.
EVTDESC_WOL_584	When my captor [From.GetTitledFirstNameNoRegnal] learned of my seduction attempt, [From.GetSubjectPronoun] had me thrown in the Oubliette!	When my captor [From.GetTitledFirstNameNoRegnal] learned of my seduction attempt, [From.GetSubjectPronoun] had me thrown in the Oubliette!
EVTOPTA_WOL_584	The [GetRootFromInsult]! I will die in this hole...	The [GetRootFromInsult]! I will die in this hole...
EVTDESC_WOL_585	The gaoler unlocked the cell and entered, leering. As he started to fondle me, I suggested heading to a more romantic location. He eagerly snuck me past a few other guards to his own cot, where I had to do things I am not proud of... Then I bashed him on the head with a heavy jug, grabbed his keys and clothes and made my escape!	The gaoler unlocked the cell and entered, leering. As he started to fondle me, I suggested heading to a more romantic location. He eagerly snuck me past a few other guards to his own cot, where I had to do things I am not proud of... Then I bashed him on the head with a heavy jug, grabbed his keys and clothes and made my escape!
EVTOPTA_WOL_585	Freedom!	Freedom!
EVTDESC_WOL_586	My chief gaoler was seduced by my prisoner, the wily [From.GetTitledName]. He took her to his cot where she bashed him on the head with a wine jug and managed to make her escape!	My chief gaoler was seduced by my prisoner, the wily [From.GetTitledName]. He took her to his cot where she bashed him on the head with a wine jug and managed to make her escape!
EVTOPTA_WOL_586	Throw the idiot in the Oubliette!	Throw the idiot in the Oubliette!
EVTDESC_WOL_590	My concubine, [target_consort.GetTitledFirstNameNoRegnal], does not love me. While love is not exactly necessary, I'd still like to see her beautiful face light up with smiles and laughter... so I've decided to romance her!	My concubine, [target_consort.GetTitledFirstNameNoRegnal], does not like me much. While love is not necessary, I'd like to see her beautiful face light up with smiles and laughter... so I've decided to romance her!
EVTOPTA_WOL_590	Turn on the charm	Turn on the charm
EVTTOOLTIP_WoL_591	The seduction of [This.GetFirstName] begins	The seduction of [This.GetFirstName] begins
EVTDESC_WOL_592	I did get my [GetFromRelation] [From.GetFirstName] to laugh today, as I told her a silly joke about two squirrels. I think she is warming up to me...	I did get my [GetFromRelation] [From.GetFirstName] to laugh today, as I told her a silly joke about two squirrels. I think she is warming up to me...
EVTDESC_WOL_592_B	I can tell my [GetFromRelation] [From.GetFirstName] is finally falling in love with me. She snuggled up to me as we watched the sunset together from the roof of the great tower.	I can tell my [GetFromRelation] [From.GetFirstName] is finally falling in love with me. She snuggled up to me as we watched the sunset together from the roof of the great tower.
EVTOPTA_WOL_592	Good, that gladdens me!	Good, that gladdens me!
EVTDESC_WOL_593	Thanks to my romantic efforts, sweet [From.GetFirstName], my [GetFromRelation], has also become my lover. It feels great to be rid of the cold awkwardness around her!	Thanks to my romantic efforts, sweet [From.GetFirstName], my [GetFromRelation], has also become my lover. It feels great to be rid of the cold awkwardness around her!
EVTOPTA_WOL_593	Finally!	Finally!
EVTDESC_WOL_594	Today, [From.GetFirstName], my [GetFromRelation], confessed that she has forgiven me for her abduction. She has grown to like her new life in [Root.Capital.Capital.GetName]... and me.	Today, [From.GetFirstName], my [GetFromRelation], confessed that she has forgiven me for her abduction. She has grown to like her new life in [Root.Capital.Capital.GetName]... and me.
EVTOPTA_WOL_594	I am relieved!	I am relieved!
EVTDESC_WOL_595	My [GetFromRelation] [From.GetFirstName] is not warming up to me at all. She laughs at my jokes, true, but not because she finds them funny, but with scorn. She told me outright that she despises me!	My [GetFromRelation] [From.GetFirstName] is not warming up to me at all. She laughs at my jokes, true, but not because she finds them funny, but with scorn. She told me outright that she despises me!
EVTOPTA_WOL_595	I'll just have to keep at it!	I'll just have to keep at it!
EVTOPTB_WOL_595	I give up. Perhaps I should put her aside...	I give up. Perhaps I should put her aside...
EVTDESC_WOL_1150	Having many lovers is exciting and fulfilling. So much love, so much desire... but so little time! I feel like I'm burning the candle at both ends.	Having many lovers is exciting and fulfilling. So much love, so much desire... but so little time! I feel like I'm burning the candle at both ends.
EVTOPTA_WOL_1150	I can make this work!	I can make this work!
EVTOPTB_WOL_1150	Break up with [first_lover.GetTitledFirstNameNoRegnal]	Break up with [first_lover.GetTitledFirstNameNoRegnal]
EVTOPTC_WOL_1150	Break up with [second_lover.GetTitledFirstNameNoRegnal]	Break up with [second_lover.GetTitledFirstNameNoRegnal]
EVTOPTD_WOL_1150	Break up with [third_lover.GetTitledFirstNameNoRegnal]	Break up with [third_lover.GetTitledFirstNameNoRegnal]
EVTDESC_WOL_1160	My beloved [my_lover.GetTitledFirstNameNoRegnal] is suffering from [my_lover.GetPossPronoun] bad marriage with [my_lover.Spouse.GetTitledFirstName]. Perhaps I should suggest a romantic retreat to the countryside, just the two of us (and our most trusted retainers)?	My beloved [my_lover.GetTitledFirstNameNoRegnal] is suffering from [my_lover.GetPossPronoun] bad marriage with [my_lover.Spouse.GetTitledFirstName]. Perhaps I should suggest a romantic retreat to the countryside, just the two of us (and our most trusted retainers)?
EVTOPTA_WOL_1160	I yearn for [my_lover.GetPossPronoun] embrace!	I yearn for [my_lover.GetPossPronoun] embrace!
EVTOPTB_WOL_1160	No. What if [my_lover.Spouse.GetFirstName] were to find out?	No. What if [my_lover.Spouse.GetFirstName] were to find out?
EVTTOOLTIP_WoL_1161	The suggestion is made. [This.GetTitledFirstNameNoRegnal] gets to decide...	The suggestion is made. [This.GetTitledFirstNameNoRegnal] gets to decide...
EVTDESC_WOL_1161	Ripped pillows, broken furniture, shattered vases... My marriage to [Root.Spouse.GetFirstName] has devolved into an unending torment of bitter arguments and fiery rows. I would be depressed, but my lover, [From.GetTitledFirstNameNoRegnal], just suggested that we retire to the countryside for a few days of carefree romance and passion!	Ripped pillows, broken furniture, shattered vases... My marriage to [Root.Spouse.GetFirstName] has devolved into an unending torment of bitter arguments and fiery rows. I would be depressed, but my lover, [From.GetTitledFirstNameNoRegnal], just suggested that we retire to the countryside for a few days of carefree romance and passion!
EVTOPTA_WOL_1161	What a splendid idea!	What a splendid idea!
EVTOPTB_WOL_1161	No... let's be together right here under [Root.Spouse.GetFirstName]'s nose!	No... let's be together right here under [Root.Spouse.GetFirstname]'s nose!
EVTOPTC_WOL_1161	I wish... but we can't risk it.	I wish... but we can't risk it.
EVTOPTD_WOL_1161	We can't! The Watcher... he sees all!	We can't! The Watcher... he sees all!
EVTTOOLTIP_WoL_1162	We risk discovery by [Root.Spouse.GetFirstName]	We risk discovery by [Root.Spouse.GetFirstName]
EVTTOOLTIP_WoL_1163	There is almost no risk of discovery by [Root.Spouse.GetFirstName]	There is almost no risk of discovery by [Root.Spouse.GetFirstName]
EVTDESC_WOL_1162	[From.GetFirstName] convinced me to stay in [From.Capital.Capital.GetName] so that we could be together right under [From.Spouse.GetTitledFirstNameNoRegnal]'s nose. We even made love in [From.Spouse.GetPossPronoun] bed!	[From.GetFirstName] convinced me to stay in [From.Capital.Capital.GetName] so that we could be together right under [From.Spouse.GetTitledFirstNameNoRegnal]'s nose. We even made love in [From.Spouse.GetPossPronoun] bed!
EVTOPTA_WOL_1162	We are so naughty...	We are so naughty...
EVTDESC_WOL_1163	My [GetFromRelation] [From.GetFirstName] and I spent a few days of romance and passion in a country house far away from the prying eyes of [From.Spouse.GetTitledFirstNameNoRegnal]...	My [GetFromRelation] [From.GetFirstName] and I spent a few days of romance and passion in a country house far away from the prying eyes of [From.Spouse.GetTitledFirstNameNoRegnal]...
EVTOPTA_WOL_1163	I am so happy! Exhausted too...	I am so happy! Exhausted too...
EVTDESC_WOL_1164	My [GetFromRelation] [From.GetFirstName] declined my suggestion that we spend some time together alone in a country house, for fear of upsetting [From.GetPossPronoun] [From.Spouse.GetHusbandWife].	My [GetFromRelation] [From.GetFirstName] declined my suggestion that we spend some time together alone in a country house, for fear of upsetting [From.GetPossPronoun] [From.Spouse.GetHusbandWife].
EVTOPTA_WOL_1164	Such a wasted opportunity!	Such a wasted opportunity!
EVTDESC_WOL_1164_MAD	My [GetFromRelation] [From.GetFirstName] declined my suggestion that we spend some time together alone in a country house, mumbling about a Watcher with 'cruel eyes' who sees all...	My [GetFromRelation] [From.GetFirstName] declined my suggestion that we spend some time together alone in a country house, mumbling about a Watcher with 'cruel eyes' who sees all...
EVTOPTA_WOL_1164_MAD	My poor love, I fear [From.GetSubjectPronoun] is losing it!	My poor love, I fear [From.GetSubjectPronoun] is losing it!
EVTOPTA_WOL_1164_MAD_MAD	Aagh! Not the Watcher! I must hide...	Aagh! Not the Watcher! I must hide...
EVTDESC_WOL_2002	Life in the shadows is a risky affair - eavesdroppers can be discovered, plots can backfire, and vengeful victims come after you dagger in hand! I am not proud of what I do, but it is for the greater good.	Life in the shadows is a risky affair - eavesdroppers can be discovered, plots can backfire, and vengeful victims come after you dagger in hand! I am not proud of what I do, but it is for the greater good.
EVTDESC_WOL_2003	Even the mightiest army can be defeated by a single [Root.GetManWoman]. Cut off the head and the body falls. I am [Root.GetFirstName] - [Root.GetMasterMistress] of Shadows.	Even the mightiest army can be defeated by a single [Root.GetManWoman]. Cut off the head and the body falls. I am [Root.GetFirstName] - [Root.GetMasterMistress] of Shadows.
EVTOPTA_WOL_2003	I shall rule from the shadows.	I shall rule from the shadows.
EVTOPTB_WOL_2003	I shall strike terror into the hearts of my foes!	I shall strike terror into the hearts of my foes!
EVTOPTC_WOL_2003	And yet, I won't let the shadows define me...	And yet, I won't let the shadows define me...
EVTDESC_WOL_2050	I - and my trusted snoops and sneaks - will keep a very close eye on the activities of [From.GetTitledName]... a close eye indeed.	I - and my trusted snoops and sneaks - will keep a very close eye on the activities of [From.GetTitledName]... a close eye indeed.
EVTOPTA_WOL_2050	I wonder what secrets [From.GetSubjectPronoun] is hiding?	I wonder what secrets [From.GetSubjectPronoun] is hiding?
EVTDESC_WOL_2061	There is no point spying on [FromFromFrom.GetTitledFirstName] anymore, considering [FromFromFrom.GetSubjectPronoun] is dead!	There is no point spying on [FromFromFrom.GetTitledFirstName] anymore, considering [FromFromFrom.GetSubjectPronoun] is dead!
EVTOPTA_WOL_2061	Time to turn my attention elsewhere.	Time to turn my attention elsewhere.
EVTDESC_WOL_2062	[FromFromFrom.GetTitledFirstName] has ended up in prison, so there's no point spying on [FromFromFrom.GetObjectPronoun] anymore.	[FromFromFrom.GetTitledFirstName] has ended up in prison, so there's no point spying on [FromFromFrom.GetObjectPronoun] anymore.
EVTDESC_WOL_2063	[FromFromFrom.GetTitledFirstName], the target of my current spy efforts, has tragically fallen comatose, making the endeavour pointless.	[FromFromFrom.GetTitledFirstName], the target of my current spy efforts, has tragically fallen comatose, making the endeavour pointless.
EVTDESC_WOL_2064	[FromFromFrom.GetTitledFirstName] is no longer present in the realm, so there is no further point to my spying.	[FromFromFrom.GetTitledFirstName] is no longer present in the realm, so there is no further point to my spying.
EVTDESC_WOL_2071	My spying on [target_spy_on.GetTitledName] has revealed [target_spy_on.GetPossPronoun] complicity in a shadowy plot to [From.GetPlot]!	My spying on [target_spy_on.GetTitledName] has revealed [target_spy_on.GetPossPronoun] complicity in a shadowy plot to [From.GetPlot]!
EVTOPTA_WOL_2071	Knowledge is power!	Knowledge is power!
EVTDESC_WOL_2080	My snoops overheard [FromFromFrom.GetTitledName] as [FromFromFrom.GetSubjectPronoun] told shocking lies about [FromFromFrom.GetPossPronoun] rightful liege! How should I use this information?	My snoops overheard [FromFromFrom.GetTitledName] as [FromFromFrom.GetSubjectPronoun] told shocking lies about [FromFromFrom.GetPossPronoun] rightful liege! How should I use this information?
EVTDESC_WOL_2080_BASTARD	I have unearthed authentic love letters proving that [FromFromFrom.GetTitledName] is actually a bastard! [FromFromFrom.GetPossPronounCap] mother, [FromFromFrom.Mother.GetTitledFirstName] had a torrid love affair with [FromFromFrom.RealFather.GetTitledName]. How should I use this shocking information?	I have unearthed authentic love letters proving that [FromFromFrom.GetTitledName] is actually a bastard! [FromFromFrom.GetPossPronounCap] mother, [FromFromFrom.Mother.GetTitledFirstName] had a torrid love affair with [FromFromFrom.RealFather.GetTitledName]. How should I use this shocking information?
EVTDESC_WOL_2080_DEVIANT	My eyes and ears have discovered the bizarre and repulsive truth about [FromFromFrom.GetTitledName]'s sexual preferences. How should I use this juicy information?	My eyes and ears have discovered the bizarre and repulsive truth about [FromFromFrom.GetTitledName]'s sexual preferences. How should I use this juicy information?
EVTDESC_WOL_2080_HERETIC	Thanks to my loyal spies, I have found out that [FromFromFrom.GetTitledName] is attempting to promote [FromFromFrom.GetPossPronoun] vile heresies. How should I use this information?	Thanks to my loyal spies, I have found out that [FromFromFrom.GetTitledName] is attempting to promote [FromFromFrom.GetPossPronoun] vile heresies. How should I use this information?
EVTDESC_WOL_2080_INFIDEL	My trusted informants tell me that [FromFromFrom.GetTitledName] is preaching [FromFromFrom.GetPossPronoun] false religion in [FromFromFrom.Capital.GetName]. How should I use this information?	My trusted informants tell me that [FromFromFrom.GetTitledName] is preaching [FromFromFrom.GetPossPronoun] false religion in [FromFromFrom.Capital.GetName]. How should I use this information?
EVTDESC_WOL_2080_TRAITOR	Though of somewhat dubious provenance, I have received information that [FromFromFrom.GetTitledName] is plotting treason against [FromFromFrom.GetPossPronoun] rightful liege! How should I use this explosive information?	Though of somewhat dubious provenance, I have received information that [FromFromFrom.GetTitledName] is plotting treason against [FromFromFrom.GetPossPronoun] rightful liege! How should I use this explosive information?
EVTOPTA_WOL_2080	Inform [target_spy_on.GetPossPronoun] liege, [target_spy_on.Liege.GetTitledName].	Inform [target_spy_on.GetPossPronoun] liege, [target_spy_on.Liege.GetTitledName].
EVTOPTB_WOL_2080	Expose and denounce [target_spy_on.GetObjectPronoun] publicly, giving me a reason to arrest [target_spy_on.GetObjectPronoun]!	Expose and denounce [target_spy_on.GetObjectPronoun] publicly, giving me a reason to arrest [target_spy_on.GetObjectPronoun]!
EVTOPTB_WOL_2080_HARSH	Denounce [target_spy_on.GetObjectPronoun], giving me reasons for arrest and revokation!	Denounce [target_spy_on.GetObjectPronoun], giving me reasons for arrest and revokation!
EVTOPTC_WOL_2080	Threaten [target_spy_on.GetFirstName] with exposure unless [target_spy_on.GetSubjectPronoun] stays out of all factions.	Threaten [target_spy_on.GetFirstName] with exposure unless [target_spy_on.GetSubjectPronoun] stays out of all factions.
EVTOPTD_WOL_2080	Threaten [target_spy_on.GetFirstName] with exposure unless [target_spy_on.GetSubjectPronoun] joins my factions.	Threaten [target_spy_on.GetFirstName] with exposure unless [target_spy_on.GetSubjectPronoun] joins my factions.
EVTOPTE_WOL_2080	Keep this information to myself.	Keep this information to myself.
EVTDESC_WOL_2081	[From.GetTitledName] claims to have proof that I have slandered [From.GetObjectPronoun] - just cause for arrest and imprisonment!	[From.GetTitledName] claims to have proof that I have slandered [From.GetObjectPronoun] - just cause for arrest and imprisonment!
EVTDESC_WOL_2081_BASTARD	[From.GetTitledName] claims to have discovered proof that my real father is in fact [Root.RealFather.GetTitledName], making me a bastard! I could be arrested, or even have my titles revoked over this!	[From.GetTitledName] claims to have discovered proof that my real father is in fact [Root.RealFather.GetTitledName], making me a bastard! I could be arrested, or even have my titles revoked over this!
EVTDESC_WOL_2081_TRAITOR	[From.GetTitledName] is publicly denouncing me as a traitor, claiming to have witnesses that can testify against me. I could be arrested, or even have my titles revoked over this!	[From.GetTitledName] is publicly denouncing me as a traitor, claiming to have witnesses that can testify against me. I could be arrested, or even have my titles revoked over this!
EVTDESC_WOL_2081_HERETIC	[From.GetTitledName] is claiming that I am promoting heresy! I could be arrested over this.	[From.GetTitledName] is claiming that I am promoting heresy! I could be arrested over this.
EVTDESC_WOL_2081_INFIDEL	[From.GetTitledName] is claiming that I am attempting to spread my [Root.Religion.GetGroupName] faith! I could be arrested over this.	[From.GetTitledName] is claiming that I am attempting to spread my [Root.Religion.GetGroupName] faith! I could be arrested over this.
EVTDESC_WOL_2081_DEVIANT	[From.GetTitledName] claims to have unearthed shocking evidence of my criminal deviancy and low morals. I could be arrested over this slander.	[From.GetTitledName] claims to have unearthed shocking evidence of my criminal deviancy and low morals. I could be arrested over this slander.
EVTOPTA_WOL_2081	Foul lies!	Foul lies!
EVTDESC_WOL_2082	[From.GetTitledName] has provided me with proof that [target_spy_on.GetTitledName] has been viciously slandering me! How should I use this information?	[From.GetTitledName] has provided me with proof that [target_spy_on.GetTitledName] has been viciously slandering me! How should I use this information?
EVTDESC_WOL_2082_BASTARD	[From.GetTitledName] has unearthed authentic love letters proving that [target_spy_on.GetTitledName] is actually a bastard! [target_spy_on.GetPossPronounCap] mother, [target_spy_on.Mother.GetTitledFirstName] had a torrid love affair with [target_spy_on.RealFather.GetTitledName]. How should I use this shocking information?	[From.GetTitledName] has unearthed authentic love letters proving that [target_spy_on.GetTitledName] is actually a bastard! [target_spy_on.GetPossPronounCap] mother, [target_spy_on.Mother.GetTitledFirstName] had a torrid love affair with [target_spy_on.RealFather.GetTitledName]. How should I use this shocking information?
EVTDESC_WOL_2082_DEVIANT	[From.GetTitledName] has given me bizarre and repulsive evidence concerning [target_spy_on.GetTitledName]'s sexual preferences. How should I use this juicy information?	[From.GetTitledName] has given me bizarre and repulsive evidence concerning [target_spy_on.GetTitledName]'s sexual preferences. How should I use this juicy information?
EVTDESC_WOL_2082_HERETIC	[From.GetTitledName] claims that [target_spy_on.GetTitledName] is attempting to promote vile heresies. How should I use this information?	[From.GetTitledName] claims that [target_spy_on.GetTitledName] is attempting to promote vile heresies. How should I use this information?
EVTDESC_WOL_2082_INFIDEL	[From.GetTitledName] tell me that [target_spy_on.GetTitledName] is preaching [target_spy_on.GetPossPronoun] false religion in [target_spy_on.Capital.Capital.GetName]. How should I respond to this?	[From.GetTitledName] tell me that [target_spy_on.GetTitledName] is preaching [target_spy_on.GetPossPronoun] false religion in [target_spy_on.Capital.Capital.GetName]. How should I respond to this?
EVTDESC_WOL_2082_TRAITOR	Though of somewhat dubious provenance, [From.GetTitledName] has presented me with evidence that [target_spy_on.GetTitledName] is plotting treason against me! How should I respond to this?	Though of somewhat dubious provenance, [From.GetTitledName] has presented me with evidence that [target_spy_on.GetTitledName] is plotting treason against me! How should I respond to this?
EVTDESC_WOL_2083	[From.GetTitledName] was grateful, and upset, about the evidence I provided against [target_spy_on.GetTitledName]. [target_spy_on.GetSubjectPronounCap] has been publicly denounced and humiliated!	[From.GetTitledName] was grateful, and upset, about the evidence I provided against [target_spy_on.GetTitledName]. [target_spy_on.GetSubjectPronounCap] has been publicly denounced and humiliated!
EVTOPTA_WOL_2083	Muahaha!	Muahaha!
EVTDESC_WOL_2084	[From.GetTitledName] was grateful, and upset, about the evidence I provided against [target_spy_on.GetTitledName], and will use it to blackmail [target_spy_on.GetObjectPronoun] out of factionalism.	[From.GetTitledName] was grateful, and upset, about the evidence I provided against [target_spy_on.GetTitledName], and will use it to blackmail [target_spy_on.GetObjectPronoun] out of factionalism.
EVTOPTA_WOL_2084	The things I do for stability in the realm...	The things I do for stability in the realm...
EVTDESC_WOL_2085	[From.GetTitledName] reacted with shock at the evidence I provided against [target_spy_on.GetTitledName], but will not take any action against [target_spy_on.GetObjectPronoun].	[From.GetTitledName] reacted with shock at the evidence I provided against [target_spy_on.GetTitledName], but will not take any action against [target_spy_on.GetObjectPronoun].
EVTOPTA_WOL_2085	A wasted opportunity!	A wasted opportunity!
EVTDESC_WOL_2086	[From.GetTitledName] claims to have proof that I have slandered [From.GetObjectPronoun]. [From.GetSubjectPronounCap] promises to keep this to [From.GetReflexivePronoun] if I promise to stay out of all factions...	[From.GetTitledName] claims to have proof that I have slandered [From.GetObjectPronoun]. [From.GetSubjectPronounCap] promises to keep this to [From.GetReflexivePronoun] if I promise to stay out of all factions...
EVTDESC_WOL_2086_BASTARD	[From.GetTitledName] claims to have discovered proof that my real father is in fact [Root.RealFather.GetTitledName], making me a bastard! [From.GetSubjectPronounCap] promises to keep this to [From.GetReflexivePronoun] if I promise to stay out of all factions...	[From.GetTitledName] claims to have discovered proof that my real father is in fact [Root.RealFather.GetTitledName], making me a bastard! [From.GetSubjectPronounCap] promises to keep this to [From.GetReflexivePronoun] if I promise to stay out of all factions...
EVTDESC_WOL_2086_TRAITOR	[From.GetTitledName] is claiming to have witnesses that can testify to the fact that I'm a traitor! [From.GetSubjectPronounCap] promises to keep this to [From.GetReflexivePronoun] if I promise to stay out of all factions...	[From.GetTitledName] is publicly denouncing me as a traitor, claiming to have witnesses that can testify against me. [From.GetSubjectPronounCap] promises to keep this to [From.GetReflexivePronoun] if I promise to stay out of all factions...
EVTDESC_WOL_2086_HERETIC	[From.GetTitledName] is claiming to know that I am promoting heresy, but promises to keep this to [From.GetReflexivePronoun] if I promise to stay out of all factions...	[From.GetTitledName] is claiming to know that I am promoting heresy, but promises to keep this to [From.GetReflexivePronoun] if I promise to stay out of all factions...
EVTDESC_WOL_2086_INFIDEL	[From.GetTitledName] is claiming to know about my attempts to spread my [Root.Religion.GetGroupName] faith! [From.GetSubjectPronounCap] promises to keep this to [From.GetReflexivePronoun] if I promise to stay out of all factions...	[From.GetTitledName] is claiming to know about my attempts to spread my [Root.Religion.GetGroupName] faith! [From.GetSubjectPronounCap] promises to keep this to [From.GetReflexivePronoun] if I promise to stay out of all factions...
EVTDESC_WOL_2086_DEVIANT	[From.GetTitledName] claims to have unearthed shocking evidence of my criminal deviancy and low morals. [From.GetSubjectPronounCap] promises to keep this to [From.GetReflexivePronoun] if I promise to stay out of all factions...	[From.GetTitledName] claims to have unearthed shocking evidence of my criminal deviancy and low morals. [From.GetSubjectPronounCap] promises to keep this to [From.GetReflexivePronoun] if I promise to stay out of all factions...
EVTOPTA_WOL_2086	I have no choice but to agree.	I have no choice but to agree.
EVTOPTB_WOL_2086	Never!	Never!
EVTDESC_WOL_2087	When confronted with the evidence, [From.GetTitledFirstName] swore to stay out of all factions and be loyal.	When confronted with the evidence, [From.GetTitledFirstName] swore to stay out of all factions and be loyal.
EVTDESC_WOL_2088	[From.GetTitledFirstName] just laughed at the evidence, flat out refusing to stop meddling in political factionalism.	[From.GetTitledFirstName] just laughed at the evidence, flat out refusing to stop meddling in political factionalism.
EVTOPTA_WOL_2088	[From.GetSubjectPronounCap] will live to regret this!	[From.GetSubjectPronounCap] will live to regret this!
EVTDESC_WOL_2090	When confronted with the evidence, [From.GetTitledFirstName] swore to join my factions.	When confronted with the evidence, [From.GetTitledFirstName] swore to join my factions.
EVTDESC_WOL_2091	[From.GetTitledFirstName] just laughed at the evidence, flat out refusing to join my factions.	[From.GetTitledFirstName] just laughed at the evidence, flat out refusing to join my factions.
EVTDESC_WOL_2100	I have found out nothing new and useful about [target_spy_on.GetTitledName], but, as my shady informant pointed out, there is nothing preventing me from making stuff up. The bigger the lie...	I have found out nothing new and useful about [target_spy_on.GetTitledName], but, as my shady informant pointed out, there is nothing preventing me from making stuff up. The bigger the lie...
EVTOPTA_WOL_2100_1	I have it! [target_spy_on.GetSubjectPronounCap] likes to dress up as a [target_spy_on.GetManWomanOpp]!	I have it! [target_spy_on.GetSubjectPronounCap] likes to dress up as a [target_spy_on.GetManWomanOpp]!
EVTOPTA_WOL_2100_2	How about a classic? [target_spy_on.GetSubjectPronounCap] takes little boys to bed!	How about a classic? [target_spy_on.GetSubjectPronounCap] takes little boys to bed!
#EVTOPTA_WOL_2100_3	Hmmm. Midgets, old shoes, animals... Yes! [target_spy_on.GetFirstName] is having an affair with a feisty goat!	Hmmm. Midgets, old shoes, animals... Yes! [target_spy_on.GetFirstName] is having an affair with a feisty goat!
EVTOPTA_WOL_2100_4	[target_spy_on.GetSubjectPronounCap] likes to bathe in the blood of virgins. Brilliant!	[target_spy_on.GetSubjectPronounCap] likes to bathe in the blood of virgins. Brilliant!
#EVTOPTA_WOL_2100_5	How about murder? I am sure [target_spy_on.GetSubjectPronoun] murdered a childhood friend at the tender age of 11.	How about murder? I am sure [target_spy_on.GetSubjectPronoun] murdered a childhood friend at the tender age of 11.
#EVTOPTA_WOL_2100_6	Aha! [target_spy_on.GetSubjectPronounCap] likes to discuss philosophy with [target_spy_on.GetPossPronoun] imaginary friend, Bappo!	Aha! [target_spy_on.GetSubjectPronounCap] likes to discuss philosophy with [target_spy_on.GetPossPronoun] imaginary friend, Bappo!
EVTOPTA_WOL_2100_7	[target_spy_on.Religion.GetRandomEvilGodNameCap]! Yes, [target_spy_on.GetSubjectPronoun] is surely a willing slave to dark forces!	[target_spy_on.Religion.GetRandomEvilGodNameCap]! Yes, [target_spy_on.GetSubjectPronoun] is surely a willing slave to dark forces!
#EVTOPTA_WOL_2100_8	[target_spy_on.GetFirstName] leads a secret life as a prostitute in the filthiest brothel in [target_spy_on.Capital.Capital.GetName]!	[target_spy_on.GetFirstName] leads a secret life as a prostitute in the filthiest brothel in [target_spy_on.Capital.Capital.GetName]!
EVTOPTB_WOL_2100	No, I need something real.	No, I need something real.
EVTTOOLTIP_WOL_2101	[This.GetTitledFirstName] finds out that I started the rumors.	[This.GetTitledFirstName] finds out that I started the rumors.
EVTDESC_WOL_2101	Several vicious rumors have been circulating about me lately. With a lot of effort, I have finally managed to trace them back to [From.GetTitledName]!	Several vicious rumors have been circulating about me lately. With a lot of effort, I have finally managed to trace them back to [From.GetTitledName]!
EVTOPTA_WOL_2101	The [GetRootFromInsult]!	The [GetRootFromInsult]!
EVTDESC_WOL_2110	One of my informants, a young soldier with more vices than he can afford, has managed to gain the trust of [FromFromFrom.GetTitledFirstNameNoRegnal] and now often stands guard outside [FromFromFrom.GetPossPronoun] door. I don't understand how the fellow managed it, but who am I to look a gift horse in the mouth? For enough gold, he might be persuaded to get rid of [FromFromFrom.GetFirstName]... violently.	One of my informants, a young soldier with more vices than he can afford, has managed to gain the trust of [FromFromFrom.GetTitledFirstNameNoRegnal] and now often stands guard outside [FromFromFrom.GetPossPronoun] door. I don't understand how the fellow managed it, but who am I to look a gift horse in the mouth? For enough gold, he might be persuaded to get rid of [FromFromFrom.GetFirstName]... violently.
EVTOPTA_WOL_2110	Yes, that would be expedient.	Yes, that would be expedient.
EVTOPTB_WOL_2110	Murder is going too far!	Murder is going too far!
EVTTOOLTIP_WOL_2111	[This.GetTitledFirstNameNoRegnal] is attacked and hopefully slain...	[This.GetTitledFirstNameNoRegnal] is attacked and hopefully slain...
EVTDESC_WOL_2111_DEATH	I try to sit up in bed, but someone is holding me down! It's the burly armsman with the trustworthy face I promoted to the guard last week. Another assailant is trying to force a rag into my mouth. Holding my nose too... can't breathe...	I try to sit up in bed, but someone is holding me down! It's the burly armsman with the trustworthy face I promoted to the guard last week. Another assailant is trying to force a rag into my mouth. Holding my nose too... can't breathe...
EVTDESC_WOL_2111_WOUNDED	I try to sit up in bed, but someone is holding me down! It's the burly armsman with the trustworthy face I promoted to the guard last week. There is a skinny little fellow with him, grinning viciously as he produces a dagger and stabs me! Screaming and thrashing about, I manage to kick the guard in the groin and break free. I punch the other one in the nose and rush from the room, trailing blood.	I try to sit up in bed, but someone is holding me down! It's the burly armsman with the trustworthy face I promoted to the guard last week. There is a skinny little fellow with him, grinning viciously as he produces a dagger and stabs me! Screaming and thrashing about, I manage to kick the guard in the groin and break free. I punch the other one in the nose and rush from the room, trailing blood.
EVTDESC_WOL_2111_LIVES	I try to sit up in bed, but someone is holding me down! It's the burly armsman with the trustworthy face I promoted to the guard last week. There is a skinny little fellow with him, grinning viciously as he produces a dagger. Screaming and thrashing about, I manage to kick the guard in the groin and break free. I punch the other one in the nose and rush from the room!	I try to sit up in bed, but someone is holding me down! It's the burly armsman with the trustworthy face I promoted to the guard last week. There is a skinny little fellow with him, grinning viciously as he produces a dagger. Screaming and thrashing about, I manage to kick the guard in the groin and break free. I punch the other one in the nose and rush from the room!
EVTOPT_WOL_2111_DEATH	I don't want to die like this!	I don't want to die like this!
EVTOPT_WOL_2111_DEATH_KNOWN	[From.GetTitledName] sends [From.GetPossPronoun] regards!'	[From.GetTitledName] sends [From.GetPossPronoun] regards!'
EVTOPT_WOL_2111_UNKNOWN	Unfortunately, the two assailants got away.	Unfortunately, the two assailants got away.
EVTOPT_WOL_2111_KNOWN	Under torture, the two men admitted that [From.GetTitledName] hired them!	Under torture, the two men admitted that [From.GetTitledName] hired them!
EVTDESC_WOL_2112	In disguise, I meet up with my friend, [From.GetTitledFirstNameNoRegnal]'s burly armsman and his shifty-looking associate at a run-down tavern. Grinning, he recounts how they stabbed [From.GetTitledName] to death in [From.GetPossPronoun] bed. I hand them a bag of coins and leave.	In disguise, I meet up with my friend, [From.GetTitledFirstNameNoRegnal]'s burly armsman and his shifty-looking associate at a run-down tavern. Grinning, he recounts how they stabbed [From.GetTitledName] to death in [From.GetPossPronoun] bed. I hand them a bag of coins and leave.
EVTOPTA_WOL_2112	Outside, I order my guards to tie up the loose ends...	Outside, I order my guards to tie up the loose ends...
EVTDESC_WOL_2113	My spy, [From.GetTitledFirstNameNoRegnal]'s burly armsman, managed to slay the [GetRootFromInsult] in [From.GetPossPronoun] bed. Unfortunately, he was captured trying to escape. My complicity is known!	My spy, [From.GetTitledFirstNameNoRegnal]'s burly armsman, managed to slay the [GetRootFromInsult] in [From.GetPossPronoun] bed. Unfortunately, he was captured trying to escape. My complicity is known!
EVTOPTA_WOL_2113	It was worth it!	It was worth it!
EVTDESC_WOL_2114	In disguise, I meet up with my friend, [From.GetTitledFirstNameNoRegnal]'s burly armsman and his shifty-looking associate at a run-down tavern. Shamefacedly, he recounts how they stabbed [From.GetTitledFirstName] in [From.GetPossPronoun] bed, and how [From.GetSubjectPronoun] somehow managed to get away. I pat him on the shoulder and tell him it's alright.	In disguise, I meet up with my friend, [From.GetTitledFirstNameNoRegnal]'s burly armsman and his shifty-looking associate at a run-down tavern. Shamefacedly, he recounts how they stabbed [From.GetTitledFirstName] in [From.GetPossPronoun] bed, and how [From.GetSubjectPronoun] somehow managed to get away. I pat him on the shoulder and tell him it's alright.
EVTDESC_WOL_2115	My spy, [From.GetTitledFirstNameNoRegnal]'s burly armsman, only managed to wound the [GetRootFromInsult]. Worse, he was captured trying to escape. My complicity is known!	My spy, [From.GetTitledFirstNameNoRegnal]'s burly armsman, only managed to wound the [GetRootFromInsult]. Worse, he was captured trying to escape. My complicity is known!
EVTOPTA_WOL_2115	I hope [From.GetSubjectPronoun] dies from infection!	I hope [From.GetSubjectPronoun] dies from infection!
EVTDESC_WOL_2116	In disguise, I meet up with my friend, [From.GetTitledFirstNameNoRegnal]'s burly armsman and his shifty-looking associate at a run-down tavern. Shamefacedly, he recounts how they attacked [From.GetTitledFirstName] in [From.GetPossPronoun] bed, but how [From.GetSubjectPronoun] managed to break free and get away. I pat him on the shoulder and tell him it's alright.	In disguise, I meet up with my friend, [From.GetTitledFirstNameNoRegnal]'s burly armsman and his shifty-looking associate at a run-down tavern. Shamefacedly, he recounts how they attacked [From.GetTitledFirstName] in [From.GetPossPronoun] bed, but how [From.GetSubjectPronoun] managed to break free and get away. I pat him on the shoulder and tell him it's alright.
EVTDESC_WOL_2117	My spy, [From.GetTitledFirstNameNoRegnal]'s burly armsman, completely botched the attack on the [GetRootFromInsult]. Worse, he was captured trying to escape. My complicity is known!	My spy, [From.GetTitledFirstNameNoRegnal]'s burly armsman, completely botched the attack on the [GetRootFromInsult]. Worse, he was captured trying to escape. My complicity is known!
EVTOPTA_WOL_2117	Incompetent bungler! I should have done it myself.	Incompetent bungler! I should have done it myself.
EVTDESC_WOL_2120	I have learned from my little birds that [FromFromFrom.GetTitledFirstNameNoRegnal] plans to travel the realm incognito for a lark, mingling with the common folk. [FromFromFrom.GetSubjectPronounCap] will only be protected by two loyal friends during this little adventure - a great opportunity to have [FromFromFrom.GetObjectPronoun] abducted, if I so wished.	I have learned from my little birds that [FromFromFrom.GetTitledFirstNameNoRegnal] plans to travel the realm incognito for a lark, mingling with the common folk. [FromFromFrom.GetSubjectPronounCap] will only be protected by two loyal friends during this little adventure - a great opportunity to have [FromFromFrom.GetObjectPronoun] abducted, if I so wished.
EVTOPTA_WOL_2120	Ah yes. It would suit my purposes marvellously!	Ah yes. It would suit my purposes marvellously!
EVTOPTB_WOL_2120	No, I have no reason to do that.	No, I have no reason to do that.
EVTTOOLTIP_WOL_2121	Some thugs are hired, with orders to bring me [FromFromFrom.GetTitledFirstNameNoRegnal] alive.	Some thugs are hired, with orders to bring me [FromFromFrom.GetTitledFirstNameNoRegnal] alive.
EVTDESC_WOL_2121	On a lark, I decided to travel among the common folk incognito with but a friend, a servant and a bodyguard. As we ride through a forest, an arrow suddenly sprouts from the neck of my trusty guard! Shouting a warning, I ride like crazy to get away...	On a lark, I decided to travel among the common folk incognito with but a friend, a servant and a bodyguard. As we ride through a forest, an arrow suddenly sprouts from the neck of my trusty guard! Shouting a warning, I ride like crazy to get away...
EVTOPT_WOL_2121_CAUGHT	...but we are surrounded! No bandits, but the agents of [From.GetTitledName].	...but we are surrounded! No bandits, but the agents of [From.GetTitledName].
EVTOPT_WOL_2121	...and manage to outdistance the bandits! Amateurs.	...and manage to outdistance the bandits! Amateurs.
EVTDESC_WOL_2122	My hired thugs managed to waylay [From.GetTitledFirstNameNoRegnal] and brought [From.GetObjectPronoun] to me in a sack!	My hired thugs managed to waylay [From.GetTitledFirstNameNoRegnal] and brought [From.GetObjectPronoun] to me in a sack!
EVTDESC_WOL_2123	The thugs I hired failed to capture [From.GetTitledFirstNameNoRegnal], though apparently they slew a guard and a servant in the attempt.	The thugs I hired failed to capture [From.GetTitledFirstNameNoRegnal], though apparently they slew a guard and a servant in the attempt.
EVTOPTA_WOL_2123	Morons! You can't find good help these days...	Morons! You can't find good help these days...
EVTDESC_WOL_2200	I have decided to free [From.GetTitledName] from the dungeons of [From.Host.GetTitledName]. It will take time - and likely some gold - but [From.GetFirstName] deserves a better fate!	I have decided to free [From.GetTitledName] from the dungeons of [From.Host.GetTitledName]. It will take time - and likely some gold - but [From.GetFirstName] deserves a better fate!
EVTOPTA_WOL_2200	I'll probably need an agent in [From.Host.Capital.Capital.GetName]...	I'll probably need an agent in [From.Host.Capital.Capital.GetName]...
EVTDESC_WOL_2201	I have decided to liberate my beloved [GetFromRelation] [From.GetFirstName] from the filthy paws of her abductor, [From.Employer.GetTitledName]. It will take time - and likely some gold - but [From.GetFirstName] deserves a better fate!	I have decided to liberate my beloved [GetFromRelation] [From.GetFirstName] from the filthy paws of her abductor, [From.Employer.GetTitledName]. It will take time - and likely some gold - but [From.GetFirstName] deserves a better fate!
EVTDESC_WOL_2211	[target_captive.GetTitledFirstName] has tragically died in captivity before I had a chance to break [target_captive.GetObjectPronoun] out.	[target_captive.GetTitledFirstName] has tragically died in captivity before I had a chance to break [target_captive.GetObjectPronoun] out.
EVTOPTA_WOL_2211	Well, it was worth a shot!	Well, it was worth a shot!
EVTDESC_WOL_2212	[target_captive.GetTitledFirstName] has tragically fallen comatose, making my endeavour to free [target_captive.GetObjectPronoun] rather pointless.	[target_captive.GetTitledFirstName] has tragically fallen comatose, making my endeavour to free [target_captive.GetObjectPronoun] rather pointless.
EVTDESC_WOL_2213	[target_captive.GetTitledFirstName] is no longer a prisoner, so I can abort my plans to free [target_captive.GetObjectPronoun].	[target_captive.GetTitledFirstName] is no longer a prisoner, so I can abort my plans to free [target_captive.GetObjectPronoun].
EVTDESC_WOL_2221	I've approached [From.GetBestName] at the court of [From.Employer.GetTitledName] with my plan to liberate [target_captive.GetTitledFirstName]. [From.GetFirstName] is sympathetic and might be persuaded to take the risk...	I've approached [From.GetBestName] at the court of [From.Employer.GetTitledName] with my plan to liberate [target_captive.GetTitledFirstName]. [From.GetFirstName] is sympathetic and might be persuaded to take the risk...
EVTOPTA_WOL_2221	Put the plan in motion!	Put the plan in motion!
EVTOPTB_WOL_2221	Bribe [From.GetFirstName] and go ahead with the plan.	Bribe [From.GetFirstName] and go ahead with the plan.
EVTOPTC_WOL_2221	Seduce [From.GetFirstName] and go ahead with the plan.	Seduce [From.GetFirstName] and go ahead with the plan.
EVTOPTD_WOL_2221	I've changed my mind. Abort the whole scheme.	I've changed my mind. Abort the whole scheme.
EVTDESC_WOL_2223	I woke from my troubled sleep with a start. Was that a thud outside my cell? Keys rattle in the lock and the door opens to a thin beam of light. It's [From.GetBestName]! 'Come with me quickly [Root.GetLordLady]! [FromFrom.GetTitledFirstNameNoRegnal] has hired me to help you escape!'	I woke from my troubled sleep with a start. Was that a thud outside my cell? Keys rattle in the lock and the door opens to a thin beam of light. It's [From.GetBestName]! 'Come with me quickly [Root.GetLordLady]! [FromFrom.GetTitledFirstNameNoRegnal] has hired me to help you escape!'
EVTOPTA_WOL_2223	Freedom!	Freedom!
EVTDESC_WOL_2224	I received some bad news this morning. My prisoner, [From.GetBestName] escaped from [From.GetPossPronoun] cell in the night. [From.GetSubjectPronounCap] had outside help - one of the guards might never wake from the blow to his head...	I received some bad news this morning. My prisoner, [From.GetBestName] escaped from [From.GetPossPronoun] cell in the night. [From.GetSubjectPronounCap] had outside help - one of the guards might never wake from the blow to his head...
EVTDESC_WOL_2224_CONSORT	My concubine [From.GetBestName] has fled! She climbed out of her tower room window, probably with outside assistance, because my guards were completely unable to locate her before she escaped my realm.	My concubine [From.GetBestName] has fled! She climbed out of her tower room window, probably with outside assistance, because my guards were completely unable to locate her before she escaped my realm.
EVTOPTA_WOL_2224	[FromFromFrom.GetTitledName] was surely behind this!	[FromFromFrom.GetTitledName] was surely behind this!
EVTDESC_WOL_2225	Good news! [From.GetBestName] was successfully sprung from captivity by the daring [FromFrom.GetBestName] and is safely back in [Root.Capital.Capital.GetName]!	Good news! [From.GetBestName] was successfully sprung from captivity by the daring [FromFrom.GetBestName] and is safely back in [Root.Capital.Capital.GetName]!
EVTDESC_WOL_2226	I woke from my troubled sleep with a start. Was that a thud outside my cell? Keys rattle in the lock and the door opens to a bright light. It's that ogre of a gaoler. 'This blighter attempted your rescue', he growls, and holds up a comatose [From.GetManWoman] like a ragdoll. '[Root.Host.GetTitledFirstNameNoRegnal] won't be too pleased, now will [Root.Host.GetSubjectPronoun]!?'	I woke from my troubled sleep with a start. Was that a thud outside my cell? Keys rattle in the lock and the door opens to a bright light. It's that ogre of a gaoler. 'This blighter attempted your rescue', he growls, and holds up a comatose [From.GetManWoman] like a ragdoll. '[Root.Host.GetTitledFirstNameNoRegnal] won't be too pleased, now will [Root.Host.GetSubjectPronoun]!?'
EVTOPTA_WOL_2226	Poor [From.GetManWoman]... was that [From.GetBestName]?	Poor [From.GetManWoman]... was that [From.GetBestName]?
EVTDESC_WOL_2227	The prison guards foiled an escape attempt last night. My treacherous [GetFromFromRelation] [FromFrom.GetBestName] was captured trying to free [From.GetTitledName] from [From.GetPossPronoun] cell!	The prison guards foiled an escape attempt last night. My treacherous [GetFromFromRelation] [FromFrom.GetBestName] was captured trying to free [From.GetTitledName] from [From.GetPossPronoun] cell!
EVTDESC_WOL_2227_CONSORT	My [GetFromRelation] [From.GetFirstName] was almost abducted last night. The treacherous [FromFrom.GetBestName] attempted to 'rescue' her by climbing in through the window, but slipped and fell! When questioned, the concussed [FromFrom.GetFirstName] admitted that [FromFromFrom.GetTitledName] was behind this chivalrous idiocy.	My [GetFromRelation] [From.GetFirstName] was almost abducted last night. The treacherous [FromFrom.GetBestName] attempted to 'rescue' her by climbing in through the window, but slipped and fell! When questioned, the concussed [FromFrom.GetFirstName] admitted that [FromFromFrom.GetTitledName] was behind this chivalrous idiocy.
EVTOPTA_WOL_2227	The dungeon is not secure enough. Throw [From.GetFirstName] in the oubliette!	The dungeon is not secure enough. Throw [From.GetFirstName] in the oubliette!
EVTOPTB_WOL_2227	Tighten security!	Tighten security!
EVTDESC_WOL_2228	The [GetRootFromInsult] [From.GetTitledFirstNameNoRegnal] had me thrown me in the oubliette to make sure I don't escape!	The [GetRootFromInsult] [From.GetTitledFirstNameNoRegnal] had me thrown me in the oubliette to make sure I don't escape!
EVTOPTA_WOL_2228	I will die here...	I will die here...
EVTDESC_WOL_2229	Bad news... [FromFrom.GetBestName] failed to free [From.GetBestName] from [From.GetPossPronoun] captivity and was imprisoned [FromFrom.GetReflexivePronoun]!	Bad news... [FromFrom.GetBestName] failed to free [From.GetBestName] from [From.GetPossPronoun] captivity and was imprisoned [FromFrom.GetReflexivePronoun]!
EVTOPTA_WOL_2229	Damnation! Security will be too tight now.	Damnation! Security will be too tight now.
EVTDESC_WOL_2300	I watched from the shadows as my spymaster, [Root.job_spymaster.GetTitledFirstNameNoRegnal], surreptitiously marked a spot on the wall with a piece of chalk. This might just be [Root.job_spymaster.GetPossPronoun] normal skulduggery, but my intuition says not...	I watched from the shadows as my spymaster, [Root.job_spymaster.GetTitledFirstNameNoRegnal], surreptitiously marked a spot on the wall with a piece of chalk. This might just be [Root.job_spymaster.GetPossPronoun] normal skulduggery, but my intuition says not...
EVTOPTA_WOL_2300	Time to spy on the spy	Time to spy on the spy
EVTDESC_WOL_2302	Eavesdropping from a secret passage in the walls, I overheard my faithless spymaster [Root.job_spymaster.GetFirstName] talking to another conspirator. They are plotting to [From.GetPlot]!	Eavesdropping from a secret passage in the walls, I overheard my faithless spymaster [Root.job_spymaster.GetFirstName] talking to another conspirator. They are plotting to [From.GetPlot]!
EVTOPTA_WOL_2302	Arrest [Root.job_spymaster.GetTitledFirstNameNoRegnal] immediately!	Arrest [Root.job_spymaster.GetTitledFirstNameNoRegnal] immediately!
EVTOPTB_WOL_2302	Hold off. I will deal with this later.	Hold off. I will deal with this later.
EVTDESC_WOL_2303	My snooping [GetFromRelation], [From.GetTitledFirstName], apparently overheard me plotting murder and did not take kindly to my plans. I have been arrested!	My snooping [GetFromRelation], [From.GetTitledFirstName], apparently overheard me plotting murder and did not take kindly to my plans. I have been arrested!
EVTDESC_WOL_2304	Over the last week, I have observed my spymaster [Root.job_spymaster.GetFirstName] carefully and found nothing further to arouse my suspicion. Perhaps I'll just have to accept that odd behaviour goes with the job...	Over the last week, I have observed my spymaster [Root.job_spymaster.GetFirstName] carefully and found nothing further to arouse my suspicion. Perhaps I'll just have to accept that odd behaviour goes with the job...
EVTOPTA_WOL_2304	I have more important things to do	I have more important things to do
EVTOPTB_WOL_2304	I can't take any chances. Have [Root.job_spymaster.GetObjectPronoun] replaced.	I can't take any chances. Have [Root.job_spymaster.GetObjectPronoun] replaced.
EVTDESC_WOL_2305	I have noticed my [GetFromRelation] [From.GetTitledFirstName] clumsily spying on me lately. It probably has something to do with [From.GetPossPronoun] unhealthy obsession with intrigue and an overly suspicious mind. I should be careful.	I have noticed my [GetFromRelation] [From.GetTitledFirstName] clumsily spying on me lately. It probably has something to do with [From.GetPossPronoun] unhealthy obsession with intrigue and an overly suspicious mind. I should be careful.
EVTOPTA_WOL_2305	Lead [From.GetObjectPronoun] a merry chase!	Lead [From.GetObjectPronoun] a merry chase!
EVTDESC_WOL_3002	I would do anything for the family, but it is hard work cultivating loyalty and devotion not just towards me, but between all the disparate members of our great House. When I'm gone, the harmony and stability I leave behind will be my greatest legacy.	I would do anything for the family, but it is hard work cultivating loyalty and devotion not just towards me, but between all the disparate members of our great House. When I'm gone, the harmony and stability I leave behind will be my greatest legacy.
EVTOPTA_WOL_3002	Hear me roar!	Hear me roar!
EVTDESC_WOL_3003	House [Root.GetOnlyDynastyName] stands firm on the rock of its proud [Root.GetPatriarchMatriarch] - [Root.GetTitledFirstNameNoRegnal]!	House [Root.GetOnlyDynastyName] stands firm on the rock of its proud [Root.GetPatriarchMatriarch] - [Root.GetTitledFirstNameNoRegnal]!
#EVTOPTA_WOL_3003	I shall be like a lion, proud and admired	I shall be like a lion, proud and admired
#EVTOPTB_WOL_3003	I shall be like a falcon, fierce but protective of its brood	I shall be like a falcon, fierce but protective of its brood
EVTOPTC_WOL_3003	No, I seek another lifestyle	No, I seek another lifestyle
EVTDESC_WOL_3010	I have been spending more time with my [target_spouse.GetHusbandWife] [target_spouse.GetFirstName] lately, and though of course we did not marry for love, I can tell it is growing between us.	I have been spending more time with my [target_spouse.GetHusbandWife] [target_spouse.GetFirstName] lately, and though of course we did not marry for love, I can tell it is growing between us.
EVTOPTA_WOL_3010	Ah, marital bliss!	Ah, marital bliss!
EVTDESC_WOL_3022	I have been making an effort to spend more time with my [GetFromRelation] [From.GetFirstName] lately. We have not always seen eye to eye, but as [From.GetPossPronoun] liege, it is especially important to foster loyalty and respect.	I have been making an effort to spend more time with my [GetFromRelation] [From.GetFirstName] lately. We have not always seen eye to eye, but as [From.GetPossPronoun] liege, it is especially important to foster loyalty and respect.
EVTDESC_WOL_3022_CHILD	My little [GetFromRelation] [From.GetFirstName] adores me, and I love playing with [From.GetObjectPronoun]. It is important to lay the groundwork for our future relations...	My little [GetFromRelation] [From.GetFirstName] adores me, and I love playing with [From.GetObjectPronoun]. It is important to lay the groundwork for our future relations...
EVTDESC_WOL_3022_ABROAD	I have been corresponding regularly with my [GetFromRelation] [From.GetFirstName], and always make sure to see [From.GetObjectPronoun] whenever I get the chance. It's a harsh world and family must stick together.	I have been corresponding regularly with my [GetFromRelation] [From.GetFirstName], and always make sure to see [From.GetObjectPronoun] whenever I get the chance. It's a harsh world and family must stick together.
EVTOPTA_WOL_3022	Family first!	Family first!
EVTDESC_WOL_3032	My [GetFromRelation] [From.GetFirstName], the [GetRootFromCompliment] [From.GetManWoman], can always rely on me for aid. I try to help out whenever and however I can, out of respect, if not love.	My [GetFromRelation] [From.GetFirstName], the [GetRootFromCompliment] [From.GetManWoman], can always rely on me for aid. I try to help out whenever and however I can, out of respect, if not love.
EVTDESC_WOL_3042	It is hard to find the time, but whenever I can, I try to spend some time with my [GetFromRelation] [From.GetFirstName]. [From.GetSubjectPronounCap] must be made to see how important family is, and to honor and love [From.GetPossPronoun] parents!	It is hard to find the time, but whenever I can, I try to spend some time with my [GetFromRelation] [From.GetFirstName]. [From.GetSubjectPronounCap] must be made to see how important family is, and to honor and love [From.GetPossPronoun] parents!
EVTDESC_WOL_3042_CHILD	As a reigning [Root.PrimaryTitle.GetRulerTitle], I rarely have any spare time, but for my little [GetFromRelation] [From.GetFirstName] I would move heaven and earth!	As a reigning [Root.PrimaryTitle.GetRulerTitle], I rarely have any spare time, but for my little [GetFromRelation] [From.GetFirstName] I would move heaven and earth!
EVTDESC_WOL_3042_ABROAD	I have been corresponding regularly with my [GetFromRelation] [From.GetFirstName], and always make sure to see [From.GetObjectPronoun] whenever I get the chance to give sage advice and remind [From.GetObjectPronoun] of [From.GetPossPronoun] duties.	I have been corresponding regularly with my [GetFromRelation] [From.GetFirstName], and always make sure to see [From.GetObjectPronoun] whenever I get the chance to give sage advice and remind [From.GetObjectPronoun] of [From.GetPossPronoun] duties.
EVTDESC_WOL_3050	I have noticed that [target_first.GetTitledFirstNameNoRegnal] and [target_second.GetTitledFirstNameNoRegnal] are not on the best of terms - a situation I hope to remedy! I have invited them both for some quality family time in [Root.Capital.Capital.GetName].	I have noticed that [target_first.GetTitledFirstNameNoRegnal] and [target_second.GetTitledFirstNameNoRegnal] are not on the best of terms - a situation I hope to remedy! I have invited them both for some quality family time in [Root.Capital.Capital.GetName].
EVTDESC_WOL_3051	My [GetFromRelation], [From.GetTitledFirstNameNoRegnal], has asked me to spend some quality family time in [From.Capital.Capital.GetName]. I am sure the idea is for me to become better friends with [target_second.GetTitledName].	My [GetFromRelation], [From.GetTitledFirstNameNoRegnal], has asked me to spend some quality family time in [From.Capital.Capital.GetName]. I am sure the idea is for me to become better friends with [target_second.GetTitledName].
EVTOPTA_WOL_3051	That sounds nice!	That sounds nice!
EVTOPTB_WOL_3051	What idiocy! I think not.	What idiocy! I think not.
EVTDESC_WOL_3053	My [GetFromRelation] [From.GetTitledFirstNameNoRegnal] refused my suggestion. There will be no reconciliation with [target_second.GetTitledName].	My [GetFromRelation] [From.GetTitledFirstNameNoRegnal] refused my suggestion. There will be no reconciliation with [target_second.GetTitledName].
EVTOPTA_WOL_3053	How foolish!	How foolish!
EVTDESC_WOL_3054	My [GetFromRelation] [From.GetTitledFirstNameNoRegnal] refused my suggestion. There will be no reconciliation with [target_first.GetTitledName].	My [GetFromRelation] [From.GetTitledFirstNameNoRegnal] refused my suggestion. There will be no reconciliation with [target_first.GetTitledName].
EVTDESC_WOL_3055	My [GetFromRelation] [From.GetTitledFirstNameNoRegnal] refused [target_initiator.GetTitledFirstNameNoRegnal]'s invitation for us all to spend some time together in [target_initiator.Capital.Capital.GetName]...	My [GetFromRelation] [From.GetTitledFirstNameNoRegnal] refused [target_initiator.GetTitledFirstNameNoRegnal]'s invitation for us all to spend some time together in [target_initiator.Capital.Capital.GetName]...
EVTOPTA_WOL_3055	How silly of [From.GetObjectPronoun]!	How silly of [From.GetObjectPronoun]!
EVTDESC_WOL_3056	[From.GetTitledFirstNameNoRegnal], [target_initiator.GetFirstName] and I had a great time together! I feel we have really strengthened our family bonds.	[From.GetTitledFirstNameNoRegnal], [target_initiator.GetFirstName] and I had a great time together! I feel we have really strengthened our family bonds.
EVTOPTA_WOL_3056	We should do it again some time.	We should do it again some time.
EVTDESC_WOL_3057	[From.GetFirstName], [FromFrom.GetFirstName] and I had the greatest time together! I am sure they like each other better now.	[From.GetFirstName], [FromFrom.GetFirstName] and I had the greatest time together! I am sure they like each other better now.
EVTDESC_WOL_3060	Constant fights and vicious pranks - my two children [target_second.GetFirstName] and [target_first.GetFirstName] just could never seem to get along, but my efforts to instill mutual love and respect have finally born fruit. This friendship will serve them well when I'm gone...	Constant fights and vicious pranks - my two children [target_second.GetFirstName] and [target_first.GetFirstName] just could never seem to get along, but my efforts to instill mutual love and respect have finally born fruit. This friendship will serve them well when I'm gone...
EVTOPTA_WOL_3060	Who can you trust, if not your siblings?	Who can you trust, if not your siblings?
EVTDESC6020_PARA	They are all watching me, conspiring... even my closest friends. Dark eyes, cold eyes... evil eyes.	They are all watching me, conspiring... even my closest friends. Dark eyes, cold eyes... evil eyes.
EVTOPTA6020_PARA	What do they want?!	What do they want?!
EVTDESC6020_FEVER	The fever has broken - perhaps only temporarily - but I can still see the shadowy figures lurking in the corners. Are they real?	The fever has broken - perhaps only temporarily - but I can still see the shadowy figures lurking in the corners. Are they real?
EVTOPTA6020_FEVER	Who are they?!	Who are they?!
EVTDESC6020_ZEAL	The dark stain of heresy has infected everyone around me. [Root.Religion.GetRandomEvilGodNameCap] is winning the war for humanity's souls. No one is pure... except me.	The dark stain of heresy has infected everyone around me. [Root.Religion.GetRandomEvilGodNameCap] is winning the war for humanity's souls. No one is pure... except me.
EVTOPTA6020_ZEAL	They must all be cleansed!	They must all be cleansed!
EVTDESC6020_PRISON	There are things in the walls. Things... Not rats, oh no! Not vermin at all... but scratching, watching, trying to drive me insane!	There are things in the walls. Things... Not rats, oh no! Not vermin at all... but scratching, watching, trying to drive me insane!
EVTOPTA6020_PRISON	I must get out of this hellhole!	I must get out of this hellhole!
EVTDESC6020_COMA	I awoke from my unending nightmare screaming. I have been in the abyss, an indescribable darkness. How long have I been asleep? Weeks, years?!	I awoke from my unending nightmare screaming. I have been in the abyss, an indescribable darkness. How long have I been asleep? Weeks, years?!
EVTOPTA6020_COMA	The darkness... it's still here!	The darkness... it's still here!
IS_PLOT_KNOWN_BY	Plot is known	Plot is known
IS_NOT_PLOT_KNOWN_BY	Plot is NOT known	Plot is NOT known
NOR_TRIGGER_STARTS	None of these must be true	None of these must be true
PATRIARCH	patriarch	patriarch
MATRIARCH	matriarch	matriarch
decision_break_free	Free from Captivity	Free from Captivity
decision_break_free_desc	Work to free §Y[This.GetTitledFirstName]§! from captivity through intrigue. Might take a long time. Requires the §YIntrigue Focus§!.	Work to free §Y[This.GetTitledFirstName]§! from captivity through intrigue. Might take a long time. Requires the §YIntrigue Focus§!.
decision_spy_on	Spy On	Spy On
decision_spy_on_desc	Keep an eye on §Y[This.GetTitledName]§! in the hopes of uncovering [This.GetPossPronoun] darkest secrets. Might allow you to blackmail, level treason charges against, or even murder [This.GetObjectPronoun]. Requires the §YIntrigue Focus§!.	Keep an eye on §Y[This.GetTitledName]§! in the hopes of uncovering [This.GetPossPronoun] darkest secrets. Might allow you to blackmail, level treason charges against, or even murder [This.GetObjectPronoun]. Requires the §YIntrigue Focus§!.
opinion_declined_romance	Declined Romance	Declined Romance
opinion_charge_heresiarch	Charge: Heresiarch	Charge: Heresiarch
opinion_charge_infidel	Charge: Infidel Preacher	Charge: Infidel Preacher
opinion_charge_deviant	Charge: Deviant	Charge: Deviant
opinion_charge_traitor	Charge: Traitor	Charge: Traitor
opinion_charge_illegitimate	Charge: Illegitimate	Charge: Illegitimate
opinion_charge_slanderer	Charge: Slanderer	Charge: Slanderer
opinion_slandered	Slandered	Slandered
opinion_spy_blackmailed	Blackmailed	Blackmailed
opinion_dominated	Dominated	Dominated
opinion_marital_love	Love	Love
opinion_family_love	Love	Love
failed_escape	Failed Escape	Failed Escape
attempted_murder_of_parent	Attempted Murder of Parent	Attempted Murder of Parent
attempted_murder_of_sibling	Attempted Murder of Sibling	Attempted Murder of Sibling
vicious_rumors	Vicious Rumors	Vicious Rumors
desc_vicious_rumors	There are all kinds of foul rumors about this character, most likely started by some rival or enemy.	There are all kinds of foul rumors about this character, most likely started by some rival or enemy.
known_murderer	Known Murderer	Known Murderer
desc_known_murderer	This character has been exposed as a murderer, vehement denials notwithstanding.	This character has been exposed as a murderer, vehement denials notwithstanding.
focus_intrigue_desc	[This.GetTitledFirstName] seeks to become a better schemer, spending most of [This.GetPossPronoun] time engrossed in court intrigue.\nThis Focus unlocks the §YSpy On§! and §YFree from Captivity§! options vs suitable targets.	[This.GetTitledFirstName] seeks to become a better schemer, spending most of [This.GetPossPronoun] time engrossed in court intrigue.\nThis Focus unlocks the §YSpy On§! and §YFree from Captivity§! options vs suitable targets.
opinion_spying_on	Spying On	Spying On
opinion_breaking_out	Breaking Out	Breaking Out
ANY_OPINION_TARGET_STARTS	Any Opinion Target	Any Opinion Target
hunting_white_stag	The White Stag Eludes Me...	The white stag eludes me...
hunting_white_bear	The White Bear Eludes Me...	The white bear eludes me...
hunting_white_tiger	The White Tiger Eludes Me...	The white tiger eludes me...
hunting_white_lion	The White Lion Eludes Me...	The white lion eludes me...
potion_unforeseen_effects	This might have unforeseen effects...	This might have unforeseen effects...
cottage_person_dies	You kill the treacherous vagrant!\n	You kill the treacherous vagrant!
nick_the_pilgrim	the Pilgrim	the Pilgrim
nick_the_shadow	the Shadow	the Shadow
nick_the_whisperer	the Whisperer	the Whisperer
nick_the_spider	the Spider	the Spider
nick_of_the_wilds	of the Wilds	of the Wilds
nick_the_impaler	the Impaler	the Impaler
nick_the_viking	the Viking	the Viking
nick_the_decadent	the Decadent	the Decadent
nick_bloodaxe	Bloodaxe	Bloodaxe
nick_the_sword_of_god	the Sword of [Root.Religion.GetRandomGodName]	the Sword of [Root.Religion.GetRandomGodName]
nick_the_culture	the [Root.Culture.GetName]	the [Root.Culture.GetName]
nick_the_rel_group	the [Root.Religion.GetGroupName]	the [Root.Religion.GetGroupName]
ARMY_LEVIES_DESC	The total amount of levies in the realm.	The total amount of levies in the realm.
RAISED	Raised	Raised
UNRAISED	Unraised	Unraised
EVTTITLE_WoL_5001_stag	The White Stag	The White Stag
EVTTITLE_WoL_5001_bear	The White Bear	The White Bear
EVTTITLE_WoL_5001_tiger	The White Tiger	The White Tiger
EVTTITLE_WoL_5001_lion	The White Lion	The White Lion
EVTDESC_WoL_5001_stag	Lately, you have heard persistent rumors from peasants and travellers in the wilds that a strange, mythical beast has been sighted in your realm. It's a white stag, powerful and elusive. The common folk claim it comes from another world and that the hunter who claims it will be imbued with divine power.	Lately, you have heard persistent rumors from peasants and travellers in the wilds that a strange, mythical beast has been sighted in your realm. It's a white stag, powerful and elusive. The common folk claim it comes from another world and that the hunter who claims it will be imbued with divine power.
EVTDESC_WoL_5001_bear	Lately, you have heard persistent rumors from peasants and travellers in the wilds that a strange, mythical beast has been sighted in your realm. It's a white bear, powerful and elusive. The common folk claim it comes from another world and that the hunter who claims it will be imbued with divine power.	Lately, you have heard persistent rumors from peasants and travellers in the wilds that a strange, mythical beast has been sighted in your realm. It's a white bear, powerful and elusive. The common folk claim it comes from another world and that the hunter who claims it will be imbued with divine power.
EVTDESC_WoL_5001_tiger	Lately, you have heard persistent rumors from peasants and travellers in the wilds that a strange, mythical beast has been sighted in your realm. It's a white tiger, powerful and elusive. The common folk claim it comes from another world and that the hunter who claims it will be imbued with divine power.	Lately, you have heard persistent rumors from peasants and travellers in the wilds that a strange, mythical beast has been sighted in your realm. It's a white tiger, powerful and elusive. The common folk claim it comes from another world and that the hunter who claims it will be imbued with divine power.
EVTDESC_WoL_5001_lion	Lately, you have heard persistent rumors from peasants and travellers in the wilds that a strange, mythical beast has been sighted in your realm. It's a white lion, powerful and elusive. The common folk claim it comes from another world and that the hunter who claims it will be imbued with divine power.	Lately, you have heard persistent rumors from peasants and travellers in the wilds that a strange, mythical beast has been sighted in your realm. It's a white lion, powerful and elusive. The common folk claim it comes from another world and that the hunter who claims it will be imbued with divine power.
EVTOPTA_WoL_5001	I must send people out to find it!	I must send people out to find it!
EVTOPTB_WoL_5001	I have no time for dreams and rumors.	I have no time for dreams and rumors.
EVTDESC_WoL_5004_stag	Good news, my [Root.GetLordLady]! We have received credible reports of a recent sighting of the great white stag in the county of [From.GetName].	Good news, my [Root.GetLordLady]! We have received credible reports of a recent sighting of the great white stag in the province of [From.GetName].
EVTDESC_WoL_5004_bear	Good news, my [Root.GetLordLady]! We have received credible reports of a recent sighting of the great white bear in the county of [From.GetName].	Good news, my [Root.GetLordLady]! We have received credible reports of a recent sighting of the great white bear in the province of [From.GetName].
EVTDESC_WoL_5004_tiger	Good news, my [Root.GetLordLady]! We have received credible reports of a recent sighting of the great white tiger in the county of [From.GetName].	Good news, my [Root.GetLordLady]! We have received credible reports of a recent sighting of the great white tiger in the province of [From.GetName].
EVTDESC_WoL_5004_lion	Good news, my [Root.GetLordLady]! We have received credible reports of a recent sighting of the great white lion in the county of [From.GetName].	Good news, my [Root.GetLordLady]! We have received credible reports of a recent sighting of the great white lion in the province of [From.GetName].
EVTOPTA_WoL_5004	Saddle my horse!	Saddle my horse!
EVTOPTB_WoL_5004	I don't have the time now.	I don't have the time now.
EVTDESC_WoL_5007_stag	On the hunt, you get separated from your party in the wilderness. As you are roaming around and trying to find your bearings, you glimpse something strange in the distance... you ride closer and see a majestic great white stag! As you cautiously approach, it sees you and runs away. You try to follow but are unable to catch up in the difficult terrain.\n\nAs you get back to your party, you find you can't stop thinking about this strange animal.	On the hunt, you get separated from your party in the wilderness. As you are roaming around and trying to find your bearings, you glimpse something strange in the distance... you ride closer and see a majestic great white stag! As you cautiously approach, it sees you and runs away. You try to follow but are unable to catch up in the difficult terrain.\n\nAs you get back to your party, you find you can't stop thinking about this strange animal.
EVTDESC_WoL_5007_bear	On the hunt, you get separated from your party in the wilderness. As you are roaming around and trying to find your bearings, you glimpse something strange in the distance... you ride closer and see a fearsome great white bear! As you cautiously approach, it sees you and runs away. You try to follow but are unable to catch up in the difficult terrain.\n\nAs you get back to your party, you find you can't stop thinking about this strange animal.	On the hunt, you get separated from your party in the wilderness. As you are roaming around and trying to find your bearings, you glimpse something strange in the distance... you ride closer and see a fearsome great white bear! As you cautiously approach, it sees you and runs away. You try to follow but are unable to catch up in the difficult terrain.\n\nAs you get back to your party, you find you can't stop thinking about this strange animal.
EVTDESC_WoL_5007_tiger	On the hunt, you get separated from your party in the wilderness. As you are roaming around and trying to find your bearings, you glimpse something strange in the distance... you ride closer and see a fearsome great white tiger! As you cautiously approach, it sees you and runs away. You try to follow but are unable to catch up in the difficult terrain.\n\nAs you get back to your party, you find you can't stop thinking about this strange animal.	On the hunt, you get separated from your party in the wilderness. As you are roaming around and trying to find your bearings, you glimpse something strange in the distance... you ride closer and see a fearsome great white tiger! As you cautiously approach, it sees you and runs away. You try to follow but are unable to catch up in the difficult terrain.\n\nAs you get back to your party, you find you can't stop thinking about this strange animal.
EVTDESC_WoL_5007_lion	On the hunt, you get separated from your party in the wilderness. As you are roaming around and trying to find your bearings, you glimpse something strange in the distance... you ride closer and see a majestic great white lion! As you cautiously approach, it sees you and runs away. You try to follow but are unable to catch up in the difficult terrain.\n\nAs you get back to your party, you find you can't stop thinking about this strange animal.	On the hunt, you get separated from your party in the wilderness. As you are roaming around and trying to find your bearings, you glimpse something strange in the distance... you ride closer and see a majestic great white lion! As you cautiously approach, it sees you and runs away. You try to follow but are unable to catch up in the difficult terrain.\n\nAs you get back to your party, you find you can't stop thinking about this strange animal.
EVTDESC_WoL_5010_stag	You have gathered your followers and your hunting dogs, you have saddled your horse and prepared your weapons. You are ready to set out to hunt the great white stag.	You have gathered your followers and your hunting dogs, you have saddled your horse and prepared your weapons. You are ready to set out to hunt the great white stag.
EVTDESC_WoL_5010_bear	You have gathered your followers and your hunting dogs, you have saddled your horse and prepared your weapons. You are ready to set out to hunt the great white bear.	You have gathered your followers and your hunting dogs, you have saddled your horse and prepared your weapons. You are ready to set out to hunt the great white bear.
EVTDESC_WoL_5010_tiger	You have gathered your followers and your hunting dogs, you have saddled your horse and prepared your weapons. You are ready to set out to hunt the great white tiger.	You have gathered your followers and your hunting dogs, you have saddled your horse and prepared your weapons. You are ready to set out to hunt the great white tiger.
EVTDESC_WoL_5010_lion	You have gathered your followers and your hunting dogs, you have saddled your horse and prepared your weapons. You are ready to set out to hunt the great white lion.	You have gathered your followers and your hunting dogs, you have saddled your horse and prepared your weapons. You are ready to set out to hunt the great white lion.
EVTOPTA_WoL_5010	An epic hunt it shall be!	An epic hunt it shall be!
EVTOPTB_WoL_5010	This time it will not escape me!	This time it will not escape me!
EVTDESC_WoL_5030_stag	After many days of hard hunting and tracking, you have finally managed to trap the white stag in a cul-de-sac between two rocks. The great animal is at your mercy - it looks at you with intelligent eyes, and you are suddenly struck by its great beauty...	After many days of hard hunting and tracking, you have finally managed to trap the white stag in a cul-de-sac between two rocks. The great animal is at your mercy - it looks at you with intelligent eyes, and you are suddenly struck by its great beauty...
EVTDESC_WoL_5030_bear	After many days of hard hunting and tracking, you have finally managed to trap the white bear in a cul-de-sac between two rocks. The great animal is at your mercy - it looks at you with intelligent eyes, and you are suddenly struck by its great beauty...	After many days of hard hunting and tracking, you have finally managed to trap the white bear in a cul-de-sac between two rocks. The great animal is at your mercy - it looks at you with intelligent eyes, and you are suddenly struck by its great beauty...
EVTDESC_WoL_5030_tiger	After many days of hard hunting and tracking, you have finally managed to trap the white tiger in a cul-de-sac between two rocks. The great animal is at your mercy - it looks at you with intelligent eyes, and you are suddenly struck by its great beauty...	After many days of hard hunting and tracking, you have finally managed to trap the white tiger in a cul-de-sac between two rocks. The great animal is at your mercy - it looks at you with intelligent eyes, and you are suddenly struck by its great beauty...
EVTDESC_WoL_5030_lion	After many days of hard hunting and tracking, you have finally managed to trap the white lion in a cul-de-sac between two rocks. The great animal is at your mercy - it looks at you with intelligent eyes, and you are suddenly struck by its great beauty...	After many days of hard hunting and tracking, you have finally managed to trap the white lion in a cul-de-sac between two rocks. The great animal is at your mercy - it looks at you with intelligent eyes, and you are suddenly struck by its great beauty...
EVTOPTA_WoL_5030	Its head will adorn my wall!	Its head will adorn my wall!
EVTOPTB_WoL_5030	I cannot slay such a noble animal.	I cannot slay such a noble animal.
EVTDESC_WoL_5035_stag	During your hunt, you come to a deep gorge. Right on the other side is the white stag, staring at you! You are so close, yet cannot reach it. As it runs away, you realize that you must return home without a victory this time.	During your hunt, you come to a deep gorge. Right on the other side is the white stag, staring at you! You are so close, yet cannot reach it. As it runs away, you realize that you must return home without a victory this time.
EVTDESC_WoL_5035_bear	During your hunt, you come to a deep gorge. Right on the other side is the white bear, staring at you! You are so close, yet cannot reach it. As it runs away, you realize that you must return home without a victory this time.	During your hunt, you come to a deep gorge. Right on the other side is the white bear, staring at you! You are so close, yet cannot reach it. As it runs away, you realize that you must return home without a victory this time.
EVTDESC_WoL_5035_tiger	During your hunt, you come to a deep gorge. Right on the other side is the white tiger, staring at you! You are so close, yet cannot reach it. As it runs away, you realize that you must return home without a victory this time.	During your hunt, you come to a deep gorge. Right on the other side is the white tiger, staring at you! You are so close, yet cannot reach it. As it runs away, you realize that you must return home without a victory this time.
EVTDESC_WoL_5035_lion	During your hunt, you come to a deep gorge. Right on the other side is the white lion, staring at you! You are so close, yet cannot reach it. As it runs away, you realize that you must return home without a victory this time.	During your hunt, you come to a deep gorge. Right on the other side is the white lion, staring at you! You are so close, yet cannot reach it. As it runs away, you realize that you must return home without a victory this time.
EVTOPTA_WoL_5035	Now I know my purpose in life!	Now I know my purpose in life!
EVTOPTB_WoL_5035	I'm sure I'll catch it someday.	I'm sure I'll catch it someday.
EVTDESC_WoL_5040	Scouring the countryside for your prey, you come upon a lone rider. As you strike up conversation, it turns out he also hunts the same great animal that you are after. His lack of success thus far seems to match yours, but he invites you to talk and share experiences.	Scouring the countryside for your prey, you come upon a lone rider. As you strike up conversation, it turns out he also hunts the same great animal that you are after. His lack of success thus far seems to match yours, but he invites you to talk and share experiences.
EVTOPTA_WoL_5040	Please join me at my court!	Please join me at my court!
EVTOPTB_WoL_5040	It's better to hunt alone.	It's better to hunt alone.
EVTOPTC_WoL_5040	A rival - he must die!	A rival - he must die!
EVTDESC_WoL_5045	You spend weeks in the wilderness searching for any trace of your prey, but to no avail. You find plenty of bugs, snakes and riding sores, however.	You spend weeks in the wilderness searching for any trace of your prey, but to no avail. You find plenty of bugs, snakes and riding sores, however.
EVTOPTA_WoL_5045	This is pointless...	This is pointless...
EVTDESC_WoL_5050	You spend weeks in the wilderness searching for any trace of your prey, but to no avail. However, you find that you rather enjoy being out in the wilds. All this daily physical activity, it makes you feel... stronger.	You spend weeks in the wilderness searching for any trace of your prey, but to no avail. However, you find that you rather enjoy being out in the wilds. All this daily physical activity, it makes you feel... stronger.
EVTOPTA_WoL_5050	This is great!	This is great!
EVTDESC_WoL_5055	You spend weeks in the wilderness searching for any trace of your prey, but are forced to return emptyhanded. You are sure that no one's impressed by your failed adventure.	You spend weeks in the wilderness searching for any trace of your prey, but are forced to return emptyhanded. You are sure that no one's impressed by your failed adventure.
EVTOPTA_WoL_5055	It's my own failure.	It's my own failure.
EVTOPTB_WoL_5055	It's because my retainers are useless!	It's because my retainers are useless!
EVTDESC_WoL_5060	Fruitlessly scouring the countryside, you come upon a small cottage in the wilds. As you knock, an old crone opens. When she sees you and your hunting party, she cackles eerily and says that she has a powerful potion that will make you a stronger hunter, sure to catch any prey.	Fruitlessly scouring the countryside, you come upon a small cottage in the wilds. As you knock, an old crone opens. When she sees you and your hunting party, she cackles eerily and says that she has a powerful potion that will make you a stronger hunter, sure to catch any prey.
EVTOPTA_WoL_5060	Sell it to me!	Sell it to me!
EVTOPTB_WoL_5060	No, let's go home, this is fruitless.	No, let's go home, this is fruitless.
EVTDESC_WoL_5061_good	You drink the potion down. Soon, you start to feel all warm inside. The crone whispers: 'See? You know that this will make you stronger, I can see it in your eyes! Now go, great hunter!'.\n\nYou return home, certain in your belief that next time you will find your prey...	You drink the potion down. Soon, you start to feel all warm inside. The crone whispers: 'See? You know that this will make you stronger, I can see it in your eyes! Now go, great hunter!'.\n\nYou return home, certain in your belief that next time you will find your prey...
EVTDESC_WoL_5061_bad	You drink the potion down. Soon, you start to feel all queasy, and then you pass out. As you awake, you have a strong headache and no desire to continue your hunting expedition. The old crone has disappeared, your guards don't seem to know how or where to.	You drink the potion down. Soon, you start to feel all queasy, and then you pass out. As you awake, you have a strong headache and no desire to continue your hunting expedition. The old crone has disappeared, your guards don't seem to know how or where to.
EVTOPTA_WoL_5061	I don't feel well...	I don't feel well...
EVTOPTC_WoL_5061	This feels good...	This feels good...
EVTDESC_WoL_5062	You have returned to your court. The hunt for this elusive white beast seems fruitless, but there are many more things out there in the wilds. Maybe next time you will catch your prey...	You have returned to your court. The hunt for this elusive white beast seems fruitless, but there are many more things out there in the wilds. Maybe next time you will catch your prey...
EVTOPTA_WoL_5062	I won't give up.	I won't give up.
EVTDESC_WoL_5065_female_lover	Fruitlessly scouring the countryside, you come upon a small cottage in the wilds. As you knock, a beautiful young woman opens. She pauses, then gives you a warm, inviting look and says: 'It's very lonely out here, I wonder if you will stay the night?'	Fruitlessly scouring the countryside, you come upon a small cottage in the wilds. As you knock, a beautiful young woman opens. She pauses, then gives you a warm, inviting look and says: 'It's very lonely out here, I wonder if you will stay the night?'
EVTDESC_WoL_5065_male_lover	Fruitlessly scouring the countryside, you come upon a small cottage in the wilds. As you knock, a handsome young man opens. He pauses, then gives you a warm, inviting look and says: 'It's very lonely out here, I wonder if you will stay the night?'	Fruitlessly scouring the countryside, you come upon a small cottage in the wilds. As you knock, a handsome young man opens. He pauses, then gives you a warm, inviting look and says: 'It's very lonely out here, I wonder if you will stay the night?'
EVTOPTA_WoL_5065	Of course...	Of course...
EVTOPTB_WoL_5065	I really shouldn't.	I really shouldn't.
EVTOPTC_WoL_5065	It's a trap! Attack!	It's a trap! Attack!
EVTDESC_WoL_5066	The next morning, you awake with a warm body next to you. You spent a long, pleasant night in the cabin but it's time to get back to the world outside. Your companion looks you in the eyes, caresses you and asks you to stay a little longer...	The next morning, you awake with a warm body next to you. You spent a long, pleasant night in the cabin but it's time to get back to the world outside. Your companion looks you in the eyes, caresses you and asks you to stay a little longer...
EVTOPTA_WoL_5066	This was nice, but I have to go.	This was nice, but I have to go.
EVTOPTB_WoL_5066	Come back to court with me!	Come back to court with me!
CONFIRM_CANCEL_PLOT_TITLE	Abandon Plot	Abandon Plot
CONFIRM_CANCEL_PLOT_DESC	Abandon the plot to $PLOT$?	Abandon the plot to $PLOT$?
CANCEL_PLOT	Cancel Plot	Cancel Plot
CANNOT_CANCEL_PLOT	This plot cannot be cancelled.	This plot cannot be cancelled.
CONFIRM_CANCEL_FOCUS_TITLE	Abandon Focus	Abandon Focus
CONFIRM_CANCEL_FOCUS_DESC	Abandon the $PLOT$ focus?	Abandon the $PLOT$ focus?
CANCEL_FOCUS_EFFECT	$CHAR$ loses the §Y$OBJECTIVE$§! focus	$CHAR$ loses the §Y$OBJECTIVE$§! focus
CANCEL_FOCUS	Cancel Focus	Cancel Focus
CANNOT_CANCEL_FOCUS	This focus cannot be cancelled.	This focus cannot be cancelled.
NO_VALID_FOCUS	No Valid Focus	No Valid Focus
CHOOSE_FOCUS	§GClick to Choose a Focus§!	§GClick to Choose a Focus§!
VASSAL_LIMIT_NOT_USED_BY_TIER	Characters of a tier this low do not use vassal limit.	Cannot use Focus without the Way of Life DLC
pet_hunting_dog	Hunting Dog	Characters of a tier this low do not use vassal limit.
pet_hunting_dog_desc	Your faithful hunting dog was given to you as a puppy and raised in your care. He is your most loyal servant and companion.	Hunting Dog
EVTDESC_WoL_5202	Your [GetFromRelation], [From.GetTitledFirstName], has sent you a gift. It is a small puppy, but of the finest pedigree and destined to grow into a great hunting dog.	Your faithful hunting dog was given to you as a puppy and raised in your care. He is your most loyal servant and companion.
EVTOPTA_WoL_5202	I will accept this gracious gift.	Your [GetFromRelation], [From.GetTitledFirstName], has sent you a gift. It is a small puppy, but of the finest pedigree and destined to grow into a great hunting dog.
EVTOPTB_WoL_5202	Send it back.	I will accept this gracious gift.
EVTOPTC_WoL_5202	Pay someone to quietly dispose of it...	Send it back.
EVTDESC_WoL_5203	Your new puppy has no name yet, my [Root.GetLordLady]. What will you call it?	Pay someone to quietly dispose of it...
EVTOPTA_WoL_5203	Faithful.	Your new puppy has no name yet, my [Root.GetLordLady]. What will you call it?
EVTOPTB_WoL_5203	Hunter.	Faithful.
EVTOPTC_WoL_5203	Tricky.	Hunter.
EVTOPTD_WoL_5203	Lucifer.	Tricky.
EVTOPTE_WoL_5203	Shaytan.	Lucifer.
EVTOPTF_WoL_5203	Fenrir.	Shaytan.
EVTOPTG_WoL_5203	Erlik.	Fenrir.
EVTOPTH_WoL_5203	Velnias.	Erlik.
EVTOPTI_WoL_5203	Tuoni.	Velnias.
EVTOPTJ_WoL_5203	Xolotl.	Tuoni.
EVTOPTK_WoL_5203	Veles.	Xolotl.
EVTOPTL_WoL_5203	Guruhi.	Veles.
EVTOPTM_WoL_5203	Darkness.	Guruhi.
EVTOPTN_WoL_5203	Ahriman.	Darkness.
EVTOPTO_WoL_5203	Satan.	Ahriman.
EVTOPTP_WoL_5203	Vinayaka.	Satan.
EVTOPTQ_WoL_5203	Mara.	Vinayaka.
EVTOPTR_WoL_5203	Punisher.	Mara.
EVTDESC_WoL_5204_good	Your dog is growing quickly and is no longer a little puppy. He runs fast and has a keen nose, and your dog handlers praise his good character.	Punisher.
EVTDESC_WoL_5204_bad	Your dog is growing quickly and is no longer a little puppy. He runs fast and has a keen nose. He bites hard too, as several of the dog handlers can testify.	Your dog is growing quickly and is no longer a little puppy. He runs fast and has a keen nose, and your dog handlers praise his good character.
EVTOPTA_WoL_5204	Good dog!	Your dog is growing quickly and is no longer a little puppy. He runs fast and has a keen nose. He bites hard too, as several of the dog handlers can testify.
EVTOPTB_WoL_5204	Hmm...	Good dog!
opinion_nice_dog	Nice Dog	Hmm...
opinion_nice_dog_children	Nice Dog	Nice dog
EVTDESC_WoL_5210	Your faithful hunting dog is always around, and always happy to see you. It is good to have such a faithful friend.	Nice dog
EVTOPTA_WoL_5210	If only people were as trustworthy.	Your faithful hunting dog is always around, and always happy to see you. It is good to have such a faithful friend.
EVTDESC_WoL_5211	Everyone at court loves your dog. Especially the children find much joy in playing with him.	If only people were as trustworthy.
EVTOPTA_WoL_5211	And he loves them.	Everyone at court loves your dog. Especially the children find much joy in playing with him.
EVTDESC_WoL_5220	Your hunting dog needs proper training if he is to perform well during hunts. Perhaps you should take a hand in this yourself?	And he loves them.
EVTOPTA_WoL_5220	Yes, I will train him personally.	Your hunting dog needs proper training if he is to perform well during hunts. Perhaps you should take a hand in this yourself?
EVTOPTB_WoL_5220	No, I have people employed for that.	Yes, I will train him personally.
trains_dog	You will spend time outside training your dog.	No, I have people employed for that.
EVTDESC_WoL_5221	In the past months you have been spending a lot of time outside, training your trusty hunting dog. You find that the combination of daily physical exercise and fresh air are doing wonders for your health and constitution.	You will spend time outside training your dog.
EVTOPTA_WoL_5221	Faithful, catch!	In the past months you have been spending a lot of time outside, training your trusty hunting dog. You find that the combination of daily physical exercise and fresh air are doing wonders for your health and constitution.
EVTOPTB_WoL_5221	Hunter, catch!	Faithful, catch!
EVTOPTC_WoL_5221	Tricky, catch!	Hunter, catch!
EVTOPTD_WoL_5221	Lucifer, catch!	Tricky, catch!
EVTOPTE_WoL_5221	Shaytan, catch!	Lucifer, catch!
EVTOPTF_WoL_5221	Fenrir, catch!	Shaytan, catch!
EVTOPTG_WoL_5221	Erlik, catch!	Fenrir, catch!
EVTOPTH_WoL_5221	Velnias, catch!	Erlik, catch!
EVTOPTI_WoL_5221	Tuoni, catch!	Velnias, catch!
EVTOPTJ_WoL_5221	Xolotl, catch!	Tuoni, catch!
EVTOPTK_WoL_5221	Veles, catch!	Xolotl, catch!
EVTOPTL_WoL_5221	Guruhi, catch!	Veles, catch!
EVTOPTM_WoL_5221	Darkness, catch!	Guruhi, catch!
EVTOPTN_WoL_5221	Ahriman, catch!	Darkness, catch!
EVTOPTO_WoL_5221	Satan, catch!	Ahriman, catch!
EVTOPTP_WoL_5221	Vinayaka, catch!	Satan, catch!
EVTOPTQ_WoL_5221	Mara, catch!	Vinayaka, catch!
EVTOPTR_WoL_5221	Punisher, catch!	Mara, catch!
EVTDESC_WoL_5230	Your hunting dog ran away and went roaming the castle. He was very aggressive, chasing several servants and sending them fleeing in terror. He then came upon the favorite dog of one of your courtiers and attacked it and killed it.	Punisher, catch!
EVTDESC_WoL_5231	Today at court, your hunting dog suddenly flew into a rage, tore loose, and attacked one of your courtiers!	Your hunting dog ran away and went roaming the castle. He was very aggressive, chasing several servants and sending them fleeing in terror. He then came upon the favorite dog of one of your courtiers and attacked it and killed it.
EVTOPTA_WoL_5231	Heel!	Today at court, your hunting dog suddenly started raging, tore loose and attacked one of your courtiers!
EVTOPTB_WoL_5231	Kill! Kill!	Heel!
EVTDESC_WoL_5290	Your faithful and trusted hunting dog has finally taken his last breath. Long has he served you since you first received him as a puppy, but now it's time to bury your old friend.	Kill! Kill!
EVTOPTA_WoL_5290	I will bury him quietly in the castle garden.	Your faithful and trusted hunting dog has finally taken his last breath. Long has he served you since you first received him as a puppy, but now it's time to bury your old friend.
EVTOPTB_WoL_5290	He deserves a proper funeral.	I will bury him quietly in the castle garden.
EVTOPTC_WoL_5290	A pyramid for Faithful!	He deserves a propel funeral.
EVTOPTD_WoL_5290	A pyramid for Hunter!	A pyramid for Faithful!
EVTOPTE_WoL_5290	A pyramid for Tricky!	A pyramid for Hunter!
EVTOPTF_WoL_5290	A pyramid for Lucifer!	A pyramid for Tricky!
EVTOPTG_WoL_5290	A pyramid for Shaytan!	A pyramid for Lucifer!
EVTOPTH_WoL_5290	A pyramid for Fenrir!	A pyramid for Shaytan!
EVTOPTI_WoL_5290	A pyramid for Erlik!	A pyramid for Fenrir!
EVTOPTJ_WoL_5290	A pyramid for Velnias!	A pyramid for Erlik!
EVTOPTK_WoL_5290	A pyramid for Tuoni!	A pyramid for Velnias!
EVTOPTL_WoL_5290	A pyramid for Xolotl!	A pyramid for Tuoni!
EVTOPTM_WoL_5290	A pyramid for Veles!	A pyramid for Xolotl!
EVTOPTN_WoL_5290	A pyramid for Guruhi!	A pyramid for Veles!
EVTOPTO_WoL_5290	A pyramid for Darkness!	A pyramid for Guruhi!
EVTOPTP_WoL_5290	A pyramid for Ahriman!	A pyramid for Darkness!
EVTOPTQ_WoL_5290	A pyramid for Satan!	A pyramid for Ahriman!
EVTOPTR_WoL_5290	A pyramid for Vinayaka!	A pyramid for Satan!
EVTOPTS_WoL_5290	A pyramid for Mara!	A pyramid for Vinayaka!
EVTOPTT_WoL_5290	A pyramid for Punisher!	A pyramid for Mara!
CHARVIEW_DIPLOMATIC_RELATIONS	Diplomacy:	A pyramid for Punisher!
BUILDING_CHECKSUM	Building Checksum...	Diplomacy:
invite_to_party	Invite to Carousing	Building Checksum...
invite_to_party_desc	Invite [Root.GetTitledFirstName] to a private feast.	Invite to Carousing
organizing_party	Preparing a Small Feast	Invite [Root.GetTitledFirstName] to a private feast.
organizing_party_desc	This character is preparing a small feast. This is a private function as opposed to the public court feasts.	Preparing a Small Feast
opinion_declined_party	Declined Invitation	This character is preparing a small feast. This is a private function as opposed to the public court feasts.
opinion_carousing	Carousing	Declined Invitation
party_carousing	Carousing!	Carousing
party_carousing_desc	This character is holding a small feast with a few select companions. This is a private function as opposed to the public court feasts.	Carousing!
carouser	Carouser	This character is holding a small feast with a few select companions. This is a private function as opposed to the public court feasts.
carouser_desc	This character likes to throw parties and have a good time with friends.	Carouser
dedicated_carouser	Dedicated Carouser	This character likes to throw parties and have a good time with friends.
dedidacted_carouser_desc	This character loves to throw parties and have a good time with friends.	Dedicated Carouser
opinion_condemned_decadence	Condemned Decadence	This character loves to throw parties and have a good time with friends.
cannibal	Cannibal	Condemned Decadence
cannibal_desc	This character likes people...	Cannibal
beaten_up	Beaten Up	This character likes people...
beaten_up_desc	This character was in a fight and ended up quite badly bruised.	Beaten Up
vice_royalty_duke_female_byzantine	Strategitissa	This character was in a fight and ended up quite badly bruised.
vice_royalty_king_female_byzantine	Exarchessa	Strategitissa
epic_hangover	Epic Hangover	Exarchessa
epic_hangover_desc	Sometimes you can take carousing and revelry too far. At such times, there is a price to pay.	Epic Hangover
EVTDESC_WoL_4000	Dear [Root.GetFirstName],\nI would like to invite you to join me for a small gathering of friends, to dine and drink and forget about the world outside for a little while. Please be prepared to reserve a few days for this, in case we get truly into the spirit of the proceedings.\n\nYours,\n[FromFrom.GetTitledName]	Sometimes you can take carousing and revelry too far. At such times, there is a price to pay.
EVTOPTA_WoL_4000	Of course I will come!	Dear [Root.GetFirstName],\n\nI would like to invite you to join me for a small gathering of friends, to dine and drink and forget about the world outside for a little while. Please be prepared to reserve a few days for this, in case we get truly into the spirit of the proceedings.\n\nYours,\n[FromFrom.GetTitledName]
EVTOPTB_WoL_4000	Unfortunately I can't.	Of course I will come!
EVTOPTC_WoL_4000	[FromFrom.GetHerHis] open decadence is shameful and I will tell [FromFrom.GetHerHim] so!	Unfortunately I can't.
EVTDESC_WoL_4001	Dear [GetFromReverseRelation],\n\nOf course I will come feast with you. I will bring my best appetite for revelry!\n\nYours,\n[From.GetTitledName]	[FromFrom.GetHerHis] open decadence is shameful and I will tell [FromFrom.GetHerHim] so!
EVTOPTA_WoL_4001	This should be fun!	Dear [GetFromReverseRelation],\n\nOf course I will come to feast with you. I will bring my best appetite for revelry!\n\nYours,\n[From.GetTitledName]
EVTDESC_WoL_4002	Dear [GetFromReverseRelation],\n\nUnfortunately I cannot join you for merrymaking at this time. But thank you for your kind invitation.\n\nUntil next time,\n[From.GetTitledName]	This should be fun!
EVTOPTA_WoL_4002	Ah, [From.GetSheHe] doesn't know what [From.GetSheHe]'s missing.	Dear [GetFromReverseRelation],\n\nUnfortunately I cannot join your for merrymaking at this time. But thank you for your kind invitation.\n\nUntil next time,\n[From.GetTitledName]
EVTDESC_WoL_4003	Dear [GetFromReverseRelation],\n\nIt saddens me that you have turned into such a decadent wretch. Surely, [From.Religion.GetRandomEvilGodName] is laughing at your escapades but I for my part refuse to partake in them.\n\nIn hope of your eventual redemption,\n[From.GetTitledName]	Ah, [From.GetSheHe] doesn't know what [From.GetSheHe]'s missing.
EVTOPTA_WoL_4003	What??	Dear [GetFromReverseRelation],\n\nIt saddens me that you have turned into such a decadent wretch. Surely, [From.Religion.GetRandomEvilGodName] is laughing at your escapades but I for my part refuse to partake in them.\n\nIn hope of your eventual redemption,\n[From.GetTitledName]
EVTOPTB_WoL_4003	At least [From.Religion.GetRandomEvilGodName] has a sense of humor.	What??
EVTDESC_WoL_4011	Unfortunate circumstances have forced me to cancel the bout of carousing that I had planned.	At least [From.Religion.GetRandomEvilGodName] has a sense of humor.
EVTDESC_WoL_4012	Dear [GetFromReverseRelation],\n\nUnfortunate circumstances force me to cancel the bout of carousing and merrymaking that we had planned. We will have to make up for it when times are happier.\n\nUntil then,\n[From.GetTitledName]	Unfortunate circumstances have forced me to cancel the bout of carousing that I had planned.
EVTDESC_WoL_4015	No one accepted my inviation to carousing. One person makes no feast, so I will have to postpone it for later.	Dear [GetFromReverseRelation],\n\nUnfortunate circumstances force me to cancel the bout of carousing and merrymaking that we had planned. We will have to make up for it when times are happier.\n\nUntil then,\n[From.GetTitledName]
EVTOPTA_WoL_4015	People are so boring!	No one accepted my inviation to carousing. One person makes no feast, so I will have to postpone it for later.
EVTDESC_WoL_4030	Your guests have arrived for the private feast you have arranged. It's time to let the carousing and merriment begin!	People are so boring!
EVTOPTA_WoL_4030	Let's get it started!	Your guests have arrived for the private feast you have arranged. It's time to let the carousing and merriment begin!
EVTDESC_WoL_4031	You have arrived at the private rooms of [From.GetTitledFirstName]. There is plenty of food and drink here, and the mood is decidedly merry. You are looking forward to this.	Let's get it started!
EVTOPTA_WoL_4031	Let's get... it started!	You have arrived at the private rooms of [From.GetTitledFirstName]. There is plenty of food and drink here, and the mood is decidedly merry. You are looking forward to this.
EVTDESC_WoL_4101	Late into the third day of feasting, you sit awake, alone, contemplating the revelries. Next to you on a couch lies one of your companions, sleeping a deep drunken sleep, defenceless and beautiful, skin glowing in the candlelight.	Let's get... it started!
EVTOPTA_WoL_4101	How peaceful this is.	Late into the third day of feasting, you sit awake, alone, contemplating the revelries. Next to you on a couch lies one of your companions, sleeping a deep drunken sleep, defenceless and beautiful, skin glowing in the candlelight.
EVTOPTB_WoL_4101	I think I will try some...	How peaceful this is.
EVTDESC_WoL_4111	Several days of feasting together, the attraction is growing, and I know we're thinking of the same thing here...	I think I will try some...
EVTOPTA_WoL_4111	Let's do it!	Several days of feasting together, the attraction is growing, and I know we're thinking of the same thing here...
EVTOPTC_WoL_4111	No, we'd better not.	Let's do it!
EVTDESC_WoL_4112	Several days of feasting together, and you have several times caught [From.GetFirstName] looking at you in that 'special' way. Finally, after a late cup of wine, [From.GetSheHe] puts [From.GetHerHis] arms around you and whispers a delicious proposal in your ear...	No, we'd better not.
EVTOPTA_WoL_4112	Yes!	Several days of feasting together, and you have several times caught [From.GetFirstName] looking at you in that 'special' way. Finally, after a late cup of wine, [From.GetSheHe] puts [From.GetHerHis] arms around you and whispers a delicious proposal in your ear...
EVTOPTB_WoL_4112	No!	Yes!
EVTDESC_WoL_4113	[From.GetFirstName] acceeded to your advances, and you spend the rest of the night together, enjoying each other...	No!
EVTOPTA_WoL_4113	I hope I'm not too drunk to remember this later!	[From.GetFirstName] acceeded to your advances, and you spend the rest of the night together, enjoying each other...
EVTDESC_WoL_4114	[From.GetFirstName] declined your amorous advances. You excuse yourself, then return to the pleasures of the table. Soon, the embarrassing moment is forgotten... almost.	I hope I'm not too drunk to remember this later!
EVTOPTA_WoL_4114	Cheers!	[From.GetFirstName] declined your amorous advances. You excuse yourself, then return to the pleasures of the table. Soon, the embarrassing moment is forgotten... almost.
EVTDESC_WoL_4120	These days of revelry are an excellent escape. So many laughs and so many intense conversations in such short a time... it brings you closer to your companions, you feel like good friends already.	Cheers!
EVTOPTA_WoL_4120	You're my... best friend!	These days of revelry are an excellent escape. So many laughs and so many intense conversations in such short a time... it brings you closer to your companions, you feel like good friends already.
EVTDESC_WoL_4131	Is it the drink? Is it something someone said? You don't remember, honestly, but someone has to pay! Fight!	You're my... best friend!
EVTOPTA_WoL_4131	Put'em up!	Is it the drink? Is it something someone said? You don't remember, honestly, but someone has to pay! Fight!
EVTDESC_WoL_4132	Good drinks and food, carousing, everything's fine. Or was fine, until [From.GetTitledFirstName] unexpectedly threw a fit of rage. You're not sure why, but [From.GetSheHe]'s coming at you right now with [From.GetHerHis] fists up.	Put'em up!
EVTOPTA_WoL_4132	Well, if that's what you want!	Good drinks and food, carousing, everything's fine. Or was fine, until [From.GetTitledFirstName] unexpectedly threw a fit of rage. You're not sure why, but [From.GetSheHe]'s coming at you right now with [From.GetHerHis] fists up.
EVTOPTB_WoL_4132	Listen to me and calm down...	Well, if that's what you want!
EVTOPTC_WoL_4132	I must escape and hide!	Listen to me and calm down...
EVTDESC_WoL_4133_fight	[From.GetTitledFirstName] put up a good fight, in spite of being just as inebriated as you. After a while you were both exhausted and had to call it a draw.	I must escape and hide!
EVTOPTA_WoL_4133	Ooh, that hurts!	[From.GetTitledFirstName] put up a good fight, in spite of being just as inebriated as you. After a while you were both exhausted and had to call it a draw.
EVTDESC_WoL_4133_talk	[From.GetTitledFirstName] started speaking to you calmly, explaining that there was no need to be upset. You considered for a moment, and then realized that [From.GetSheHe] was right. You ended up sitting down to eat and drink together again.	Ooh, that hurts!
EVTOPTB_WoL_4133	I honestly don't remember what I was so angry about.	[From.GetTitledFirstName] started speaking to you calmly, explaining that there was no need to be upset. You considered for a moment, and then realized that [From.GetSheHe] was right. You ended up sitting down to eat and drink together again.
EVTDESC_WoL_4133_hide	At the last moment, [From.GetSheHe] ran out, after throwing a chair at you and making you stumble. You searched everywhere but couldn't find [From.GetHerHim].	I honestly don't remember what I was so angry about.
EVTOPTC_WoL_4133	Maybe it's just as well. I'm not even angry anymore.	At the last moment, [From.GetSheHe] ran out, after throwing a chair at you and making you stumble. You searched everywhere but couldn't find [From.GetHerHim].
EVTDESC_WoL_4141	This party needs some action! I'm going to get undressed. Then perhaps, yes, I'll bring some animals in here, and maybe, yes that spear. And, and... set fire to the table, roast the food over it, then... where are my pants? Oh, right, I took them off! What now, hahaha, there you are, oh, ouch!! I just sat on the spear, how... amusing. I don't know, why is everybody laughing - this is great!	Maybe it's just as well. I'm not even angry anymore.
EVTOPTA_WoL_4141	Pass me the wine!	This party needs some action! I'm going to get undressed. Then perhaps, yes, I'll bring some animals in here, and maybe, yes that spear. And, and... set fire to the table, roast the food over it, then... where are my pants? Oh, right, I took them off! What now, hahaha, there you are, oh, ouch!! I just sat on the spear, how... amusing. I don't know, why is everybody laughing - this is great!
EVTDESC_WoL_4142	[From.GetTitledFirstName] is feasting and revelling like a lunatic. You can hardly stand up, you're laughing so hard.	Pass me the wine!
EVTOPTA_WoL_4142	I must invite [From.GetHerHim] more often!	[From.GetTitledFirstName] is feasting and revelling like a lunatic. You can hardly stand up, you're laughing so hard.
EVTDESC_WoL_4151	We're having a great time carousing. My comrades say I should slow down on the drink, but that's all nonsense.	I must invite [From.GetHerHim] more often!
EVTOPTA_WoL_4151	I can handle it!	We're having a great time carousing. My comrades say I should slow down on the drink, but that's all nonsense.
EVTDESC_WoL_4152_non_drunkard	[From.GetTitledFirstName] is clearly going overboard with [From.GetHerHis] drinking.	I can handle it!
EVTDESC_WoL_4152_drunkard	[From.GetTitledFirstName] is drinking like a champion!	[From.GetTitledFirstName] is clearly going overboard with [From.GetHerHis] drinking.
EVTOPTA_WoL_4152	[From.GetSheHeCap] should take it easier.	[From.GetTitledFirstName] is drinking like a champion!
EVTOPTB_WoL_4152	Cheers!	[From.GetSheHeCap] should take it easier.
EVTDESC_WoL_4800	The revelling and carousing is over... for now. Time to get back to real life.	Cheers!
EVTOPTA_WoL_4800	Well, it was fun.	The revelling and carousing is over... for now. Time to get back to real life.
EVTOPTB_WoL_4800	This is the real life!	Well, it was fun.
EVTOPTC_WoL_4800	Life is all about enjoying the company of others.	This is the real life!
POSS_PRONOUN_FEM	her	Life is all about enjoying the company of others.
OBJ_PRONOUN_FEM	her	her
CURRENT_FOCUS	This is your current focus.	her
CANNOT_CANCEL_CURRENT_FOCUS	Your current focus cannot be cancelled.	This is your current focus.
CHOOSE_NEW_FOCUS	§GClick to Choose a new Focus§!	Your current focus cannot be cancelled.
studying_the_stars	Studying the Stars	§GClick to Choose a new Focus§!
studying_the_stars_desc	This character has built an observatory and spends any clear nights studying the stars above...	Studying the Stars
heliocentrist_scholar	Heliocentrist Scholar	This character has built an observatory and spends any clear nights studying the stars above...
heliocentrist_scholar_desc	This character has done research to prove that the Earth revolves around the Sun.	Heliocentrist Scholar
weird_scholar	Weird Scholar	This character has done research to prove that the Earth revolves around the Sun.
weird_scholar_desc	This character has done research into the strange and mysterious...	Weird Scholar
the_necronomicon	The Necronomicon	This character has done research into the strange and mysterious...
the_necronomicon_desc	This character possesses a copy of the mysterious book known as The Necronomicon.	The Necronomicon
build_observatory	Build Observatory	This character possesses a copy of the mysterious book known as The Necronomicon.
build_observatory_desc	I can invest in building an observatory to start studying the stars and other celestial bodies. Who knows what I might learn?	Build Observatory
EVTDESC_WoL_6000	You have begun construction of an observatory. It will take some time to collect all the necessary materials and get everything in order.	I can invest in building an observatory to start studying the stars and other celestial bodies. Who knows what I might learn?
EVTOPTA_WoL_6000	I can't wait!	You have begun construction of an observatory. It will take some time to collect all the necessary materials and get everything in order.
EVTDESC_WoL_6010	Your observatory is finally ready. It is with great anticipation that you prepare to make your first observations.	I can't wait!
EVTOPTA_WoL_6010	I wonder what strange things I will discover.	Your observatory is finally ready. It is with great anticipation that you prepare to make your first observations.
EVTDESC_WoL_6020	You have spent many nights looking at the stars in your observatory. It is truly fascinating, there are so many questions to ask...	I wonder what strange things I will discover.
EVTOPTA_WoL_6020	How do the stars move?	You have spent many nights looking at the stars in your observatory. It is truly fascinating, there are so many questions to ask...
EVTOPTB_WoL_6020	Is there something... strange out there?	How do the stars move?
EVTDESC_WoL_6100	Observing the movements of the stars at night, you have begun to see some regular patterns. These observations, however, have raised many new questions. You are starting to wonder, for example, if the Earth is really at the center of it all.	Is there something... strange out there?
EVTOPTA_WoL_6100	Interesting...	Observing the movements of the stars at night, you have begun to see some regular patterns. These observations, however, have raised many new questions. You are starting to wonder, for example, if the Earth is really at the center of it all.
EVTDESC_WoL_6110	The reasearch you conduct in your observatory at night is proving deeply fascinating. You could push your studies further, but you'd need to purchase more equipment for it to be meaningful.	Interesting...
EVTOPTA_WoL_6110	I must move forward!	The reasearch you conduct in your observatory at night is proving deeply fascinating. You could push your studies further, but you'd need to purchase more equipment for it to be meaningful.
EVTOPTB_WoL_6110	No, this is proving too expensive.	I must move forward!
EVTDESC_WoL_6122	One morning, your [GetFromRelation] [From.GetTitledFirstName] comes to see you. [From.GetSheHeCap] says: 'I am worried. I have heard that you are spending late nights studying the sky and entertaining heretical notions about the cosmos. I would ask that you stop, for your own sake.'	No, this is proving too expensive.
EVTOPTA_WoL_6122	Don't worry, I'm fine...	One morning, your [GetFromRelation] [From.GetTitledFirstName] comes to see you. [From.GetSheHeCap] says: 'I am worried. I have heard that you are spending late nights studying the sky and entertaining heretical notions about the cosmos. I would ask that you stop, for your own sake.'
EVTOPTB_WoL_6122	Stay out of my business!	Don't worry, I'm fine...
EVTOPTC_WoL_6122	It is not what you think, I am only... writing poetry.	Stay out of my business!
EVTDESC_WoL_6130	You nightly studies of the movements of the celestial bodies are increasing your knowledge of a great many things. You feel that you are getting closer to understanding the universe.	It is not what you think, I am only... writing poetry.
EVTOPTA_WoL_6130	I sense a harmony out there...	You nightly studies of the movements of the celestial bodies are increasing your knowledge of a great many things. You feel that you are getting closer to understanding the universe.
EVTDESC_WoL_6140	Working in your observatory, lately you are often frustrated by broken equipment, weeks on end of cloudy weather and frequent interruptions by curious intruders and even animals. It's very hard to maintain concentration and get anything done.	I sense a harmony out there...
EVTOPTA_WoL_6140	I must persist, the truth is out there.	Working in your observatory, lately you are often frustrated by broken equipment, weeks on end of cloudy weather and frequent interruptions by curious intruders and even animals. It's very hard to maintain concentration and get anything done.
EVTOPTB_WoL_6140	It's no use!	I must persist, the truth is out there.
EVTDESC_WoL_6152	Dear [Root.GetTitledName],\nI have been told that you are pursuing studies in fields that deny the truths of [Root.Religion.GetRandomGodName]. I am certain that such rumors are only slander and that you would never do such a thing. If it were true, however, I would be most disappointed.\n\nIn the name of [Root.Religion.GetRandomGodName],\n[From.GetTitledName]	It's no use!
EVTOPTA_WoL_6152	The [From.GetTitle] should stay out of my business!	Dear [Root.GetTitledName],\nI have been told that you are pursuing studies in fields that deny the truths of [Root.Religion.GetRandomGodName]. I am certain that such rumors are only slander and that you would never do such a thing. If it were true, however, I would be most disappointed.\n\nIn the name of [Root.Religion.GetRandomGodName],\n[From.GetTitledName]
EVTOPTB_WoL_6152	The best answer to this is silence.	The [From.GetTitle] should stay out of my business!
EVTOPTC_WoL_6152	I must not challenge conventional wisdom.	The best answer to this is silence.
EVTDESC_WoL_6160	You studies of the celestial spheres are progressing well. You see movements and relationships that you had never dared guess at. It seems clear to you now that the laws that guide the movements of the stars must also be reflected on Earth in some way..	I must not challenge conventional wisdom.
EVTOPTA_WoL_6160	And what is Earth?	You studies of the celestial spheres are progressing well. You see movements and relationships that you had never dared guess at. It seems clear to you now that the laws that guide the movements of the stars must also be reflected on Earth in some way..
EVTDESC_WoL_6170	You are sure you have made a breakthrough in your studies. Yes, it cannot be otherwise. The Earth is round, and it revolves around the Sun. How little we know of the Universe!	And what is Earth?
EVTOPTA_WoL_6170	I must publish my findings!	You are sure you have made a breakthrough in your studies. Yes, it cannot be otherwise. The Earth is round, and it revolves around the Sun. How little we know of the Universe!
EVTOPTB_WoL_6170	I will continue my studies in secret.	I must publish my findings!
EVTOPTC_WoL_6170	I will stop with this achievement.	I will continue my studies in secret.
EVTOPTD_WoL_6170	No! This is [Root.Religion.GetRandomEvilGodName] speaking!	I will stop with this achievement.
EVTDESC_WoL_6300	Observing the stars at night, you have begun to sense some irregular movements. You also notice that some stars seem to appear and disappear at odd times. You need to study this more...	No! This is [Root.Religion.GetRandomEvilGodName] speaking!
EVTOPTA_WoL_6300	That star there disappears when I look directly at it.	Observing the stars at night, you have begun to sense some irregular movements. You also notice that some stars seem to appear and disappear at odd times. You need to study this more...
EVTDESC_WoL_6322	One morning, your [GetFromRelation] [From.GetTitledFirstName] comes to see you. [From.GetSheHeCap] says: 'I am worried. I have heard that you are spending late nights staring at the sky, speaking in odd riddles and entertaining heretical notions about the cosmos. I would ask that you stop, for your own sake.'	That star there disappears when I look directly at it.
EVTOPTA_WoL_6322	I am only admiring the beauty of the stars.	One morning, your [GetFromRelation] [From.GetTitledFirstName] comes to see you. [From.GetSheHeCap] says: 'I am worried. I have heard that you are spending late nights staring at the sky, speaking in odd riddles and entertaining heretical notions about the cosmos. I would ask that you stop, for your own sake.'
EVTOPTB_WoL_6322	There are strange things out there and I need to see them!	I am only admiring the beauty of the stars.
EVTOPTC_WoL_6322	What you heard are lies.	There are strange things out there and I need to see them!
EVTDESC_WoL_6330	The studies you have conducted in your observatory have convinced you that there are many strange things beyond the known cosmos. There are few sources and no one to share knowledge with you, however. But you have heard of a strange old scholar in the Arabian Desert who is rumored to possess vast knowledge of the weird.	What you heard are lies.
EVTOPTA_WoL_6330	I will go and see him.	The studies you have conducted in your observatory have convinced you that there are many strange things beyond the known cosmos. There are few sources and no one to share knowledge with you, however. But you have heard of a strange old scholar in the Arabian Desert who is rumored to possess vast knowledge of the weird.
EVTOPTB_WoL_6330	No, this frightens me. I should stop.	I will go and see him.
EVTTITLE_WoL_6331	The Necronomicon	No, this frightens me. I should stop.
EVTDESC_WoL_6331	You arrive at the abode of the strange old scholar Ibrahim. After some persuasion, he invites you in. You speak at length, and he tells of you of the scholar Abdul the Mad, who knew many things of the strange spheres beyond and of talking beings that are not human. You find out that Abdul the Mad wrote a book called the Necronomicon, in which he recorded many strange and unholy truths. Ibrahim says that as he is impressed by your sincerity and desire for knowledge, he can sell you a copy of the book. He tells you to beware, however, as too much intense study of the Necronomicon is said to drive the reader insane...	The Necronomicon
EVTOPTA_WoL_6331	Yes, I must have it!	You arrive at the abode of the strange old scholar Ibrahim. After some persuasion, he invites you in. You speak at length, and he tells of you of the scholar Abdul the Mad, who knew many things of the strange spheres beyond and of talking beings that are not human. You find out that Abdul the Mad wrote a book called the Necronomicon, in which he recorded many strange and unholy truths. Ibrahim says that as he is impressed by your sincerity and desire for knowledge, he can sell you a copy of the book. He tells you to beware, however, as too much intense study of the Necronomicon is said to drive the reader insane...
EVTOPTB_WoL_6331	No, thanks.	Yes, I must have it!
EVTDESC_WoL_6336	Shortly after the death of your [GetFromRelation] [From.GetTitledFirstNameWithNick], you are brought a strange piece of news. It seems that [From.GetHerHis] library was raided, the only item stolen being a strange old book of Arabian origin. Two servants who were in the library at the time were found dead, though witnesses refused to describe the state of the bodies.	No, thanks.
EVTOPTA_WoL_6336	Strange...	Shortly after the death of your [GetFromRelation] [From.GetTitledFirstNameWithNick], you are brought a strange piece of news. It seems that [From.GetHerHis] library was raided, the only item stolen being a strange old book of Arabian origin. Two servants who were in the library at the time were found dead, though witnesses refused to describe the state of the bodies.
EVTDESC_WoL_6340	Working in your observatory, you are often disturbed by strange noises, uncannily large insects carrying away smaller pieces of equipment and odd human-like figures spying on you and then disappearing into the night before you can confront them. You really struggle to maintain concentration and get anything done.	Strange...
EVTOPTA_WoL_6340	I must focus!	Working in your observatory, you are often disturbed by strange noises, uncannily large insects carrying away smaller pieces of equipment and odd human-like figures spying on you and then disappearing into the night before you can confront them. You really struggle to maintain concentration and get anything done.
EVTOPTB_WoL_6340	It's no use, I should give this up.	I must focus!
EVTDESC_WoL_6350	The book you bought from the strange desert scholar has proven quite useful for gaining new ideas and insights in your studies of the stars and what lies beyond. It does, however, contain some quite disturbing texts and images, things that lead towards a level of understanding that might make one... mad.	It's no use, I should give this up.
EVTOPTA_WoL_6350	I should leave it on the shelf for now.	The book you bought from the strange desert scholar has proven quite useful for gaining new ideas and insights in your studies of the stars and what lies beyond. It does, however, contain some quite disturbing texts and images, things that lead towards a level of understanding that might make one... mad.
EVTOPTB_WoL_6350	I must delve deeper!	I should leave it on the shelf for now.
EVTDESC_WoL_6360	Great wisdom comes to those who study the world and learn from it. Your studies of the stars and other things beyond this world have taken you on very strange paths, and your learning has increased immeasurably since you started.	I must delve deeper!
EVTOPTA_WoL_6360	The stars are right!	Great wisdom comes to those who study the world and learn from it. Your studies of the stars and other things beyond this world have taken you on very strange paths, and your learning has increased immeasurably since you started.
EVTDESC_WoL_6370	You are finally certain, absolutely certain. There are things you understand now that lie beyond the ken of normal [Root.GetMenWomen]. If they knew, oh if they knew! But it is the task of scholars such as you to keep and preserve such things in secret, lest all humanity go insane with the knowledge of its own insignificance.	The stars are right!
EVTOPTA_WoL_6370	I shall be a devoted keeper of elder secrets.	You are finally certain, absolutely certain. There are things you understand now that lie beyond the ken of normal [Root.GetMenWomen]. If they knew, oh if they knew! But it is the task of scholars such as you to keep and preserve such things in secret, lest all humanity go insane with the knowledge of its own insignificance.
EVTOPTB_WoL_6370	I will hide this and dedicate myself to other things.	I shall be a devoted keeper of elder secrets.
IS_HOLY_SITE_OF	Is holy site of $RELIGION$.	I will hide this and dedicate myself to other things.
IS_NOT_HOLY_SITE_OF	Is not holy site of $RELIGION$.	Is holy site of $RELIGION$.
theologian	Theologian	Is not holy site of $RELIGION$.
theologian_desc	This character is dedicating [GetHerHis] life to religious studies.	Theologian
religious_studies	Religious Studies	This character is dedicating [GetHerHis] life to religious studies.
religious_studies_desc	This character is a seeker of religious knowledge and insights.	Religious Studies
religious_philosopher	Religious Philosopher	This character is a seeker of religious knowledge and insights.
religious_philosopher_desc	This character is an experienced and dedicated seeker of religious knowledge and insights.	Religious Philosopher
EVTDESC_WoL_7000_non_unref_pagan	There are many mysteries in the [Root.Religion.GetName] faith. It might be interesting to spend some time delving into the old texts of  [Root.Religion.GetScriptureName].	This character is an experienced and dedicated seeker of religious knowledge and insights.
EVTDESC_WoL_7000_unref_pagan	There are many mysteries in the [Root.Religion.GetName] faith. It might be interesting to listen more to the ancient stories told by the [Root.Religion.GetPriestTitle]s.	There are many mysteries in the [Root.Religion.GetName] faith. It might be interesting to spend some time delving into the old texts of  [Root.Religion.GetScriptureName].
EVTOPTA_WoL_7000	I will dedicate more time to reading the scriptures.	There are many mysteries in the [Root.Religion.GetName] faith. It might be interesting to listen more to the ancient stories told by the [Root.Religion.GetPriestTitle]s.
EVTOPTB_WoL_7000	I shall summon storytellers.	I will dedicate more time to reading the scriptures.
EVTOPTC_WoL_7000	No, I have no time for this.	I shall summon storytellers.
EVTDESC_WoL_7001_non_unref_pagan	In the past few months, you have been spending many nights reading [Root.Religion.GetScriptureName]. The texts contain many items of wisdom and also give hints to the most important mysteries of [Root.Religion.GetRandomGodName].	No, I have no time for this.
EVTDESC_WoL_7001_unref_pagan	In the past few months, you have spent many nights listening to the old myths and stories of the [Root.Religion.GetName] faith. The tales told of [Root.Religion.GetRandomGodName] are most inspiring and contain much wisdom that can help you in your daily life.	In the past few months, you have been spending many nights reading [Root.Religion.GetScriptureName]. The texts contain many items of wisdom and also give hints to the most important mysteries of [Root.Religion.GetRandomGodName].
EVTOPTA_WoL_7001	These sacred texts illuminate me.	In the past few months, you have spent many nights listening to the old myths and stories of the [Root.Religion.GetName] faith. The tales told of [Root.Religion.GetRandomGodName] are most inspiring and contain much wisdom that can help you in your daily life.
EVTOPTB_WoL_7001	It is wise to listen and ponder.	These sacred texts illuminate me.
ancient_wisdom	Ancient Wisdom	It is wise to listen and ponder.
ancient_wisdom_desc	The ancient myths and stories contain many words of wisdom.	Ancient Wisdom
EVTDESC_WoL_7012	Your dedication to religious pursuits has been noticed around the realm. Among others, it has quite impressed [From.GetTitledName]. You have maintained correspondence on various religious and philosophical matters for some time, and find that you are rapidly becoming good friends.	The ancient myths and stories contain many words of wisdom.
EVTOPTA_WoL_7012	Our common interests bind us together.	Your dedication to religious pursuits has been noticed around the realm. Among others, it has quite impressed [From.GetTitledName]. You have maintained correspondence on various religious and philosophical matters for some time, and find that you are rapidly becoming good friends.
EVTDESC_WoL_7020	The holy site of [holy_site_visiting.GetName] is an important center of the [Root.Religion.GetName] faith. Many great religious events are celebrated there, and the spirit of [Root.Religion.GetRandomGodName] is said to permeate the entire area.	Our common interests bind us together.
EVTOPTA_WoL_7020	I should go!	The holy site of [holy_site_visiting.GetName] is an important center of the [Root.Religion.GetName] faith. Many great religious events are celebrated there, and the spirit of [Root.Religion.GetRandomGodName] is said to permeate the entire area.
EVTOPTB_WoL_7020	I can't.	I should go!
EVTDESC_WoL_7021	Your visit to [holy_site_visiting.GetName] was certainly worth the time! You have wandered around in its sacred halls and pondered the atmosphere and the religious mysteries that lie hidden here.	I can't.
EVTOPTA_WoL_7021	Praise [Root.Religion.GetRandomGodName]!	Your visit to [holy_site_visiting.GetName] was certainly worth the time! You have wandered around in its sacred halls and pondered the atmosphere and the religious mysteries that lie hidden here.
grievously_offended	Grievously Offended	Praise [Root.Religion.GetRandomGodName]!
merciless	Merciless	Grievously Offended
merciless_desc	This character is known to show no mercy.	Merciless
		This character is known to show no mercy.
